1,441,-44,541,541,0.99
2,441,-44,389,930,0.99
3,441,-44,575,1505,0.99
4,441,-44,640,2145,0.99
5,441,-44,496,2641,0.99
6,441,-44,226,2867,0.99
7,441,-44,286,3153,0.99
8,441,-44,189,3342,0.99
9,441,-44,200,3542,0.99
10,441,-44,199,3741,0.99
11,441,-44,404,4145,0.99
12,441,-44,283,4428,0.99
13,441,-44,262,4690,0.99
14,441,-44,288,4978,0.99
15,441,-44,342,5320,0.99
16,441,-44,376,5696,0.99
17,441,-44,334,6030,0.99
18,441,-44,328,6358,0.99
19,441,-44,321,6679,0.99
20,441,-44,383,7062,0.99
21,441,-44,330,7392,0.99
22,441,-44,324,7716,0.99
23,441,-44,375,8091,0.99
24,441,-44,400,8491,0.99
25,441,-44,373,8864,0.99
26,441,-44,383,9247,0.99
27,441,-44,401,9648,0.99
28,441,-44,400,10048,0.99
29,441,-44,364,10412,0.99
30,441,-44,448,10860,0.99
31,441,-44,415,11275,0.99
32,441,-44,476,11751,0.99
33,441,-44,440,12191,0.99
34,441,-44,437,12628,0.99
35,441,-44,470,13098,0.99
36,441,-44,429,13527,0.99
37,441,-44,489,14016,0.99
38,441,-44,445,14461,0.99
39,441,-44,509,14970,0.99
40,441,-44,462,15432,0.99
41,441,-44,468,15900,0.99
42,441,-44,527,16427,0.99
43,441,-44,538,16965,0.99
44,441,-44,523,17488,0.99
45,441,-44,524,18012,0.99
46,441,-44,511,18523,0.99
47,441,-44,505,19028,0.99
48,441,-44,529,19557,0.99
49,441,-44,578,20135,0.99
50,441,-44,570,20705,0.99
51,441,-44,562,21267,0.99
52,441,-44,568,21835,0.99
53,441,-44,550,22385,0.99
54,441,-44,551,22936,0.99
55,441,-44,565,23501,0.99
56,441,-44,579,24080,0.99
57,441,-44,601,24681,0.99
58,441,-44,647,25328,0.99
59,441,-44,613,25941,0.99
60,441,-44,619,26560,0.99
61,441,-44,625,27185,0.99
62,441,-44,631,27816,0.99
63,441,-44,640,28456,0.99
64,441,-44,637,29093,0.99
65,441,-44,618,29711,0.99
66,441,-44,599,30310,0.99
67,441,-44,777,31087,0.99
68,441,-44,751,31838,0.99
69,441,-44,756,32594,0.99
70,441,-44,703,33297,0.99
71,441,-44,687,33984,0.99
72,441,-44,693,34677,0.99
73,441,-44,693,35370,0.99
74,441,-44,695,36065,0.99
75,441,-44,676,36741,0.99
76,441,-44,667,37408,0.99
77,441,-44,691,38099,0.99
78,441,-44,695,38794,0.99
79,441,-44,676,39470,0.99
80,441,-44,682,40152,0.99
81,441,-44,731,40883,0.99
82,441,-44,744,41627,0.99
83,441,-44,674,42301,0.99
84,441,-44,739,43040,0.99
85,441,-44,751,43791,0.99
86,441,-44,707,44498,0.99
87,441,-44,747,45245,0.99
88,441,-44,743,45988,0.99
89,441,-44,756,46744,0.99
90,441,-44,745,47489,0.99
91,441,-44,726,48215,0.99
92,441,-44,759,48974,0.99
93,441,-44,778,49752,0.99
94,441,-44,771,50523,0.99
95,441,-44,806,51329,0.99
96,441,-44,798,52127,0.99
97,441,-44,786,52913,0.99
98,441,-44,775,53688,0.99
99,441,-44,791,54479,0.99
100,441,-44,813,55292,0.99
101,441,-44,796,56088,0.99
102,441,-44,789,56877,0.99
103,441,-44,801,57678,0.99
104,441,-44,857,58535,0.99
105,441,-44,781,59316,0.99
106,441,-44,836,60152,0.99
107,441,-44,889,61041,0.99
108,441,-44,901,61942,0.99
109,441,-44,906,62848,0.99
110,441,-44,882,63730,0.99
111,441,-44,840,64570,0.99
112,441,-44,831,65401,0.99
113,441,-44,858,66259,0.99
114,441,-44,841,67100,0.99
115,441,-44,860,67960,0.99
116,441,-44,895,68855,0.99
117,441,-44,885,69740,0.99
118,441,-44,923,70663,0.99
119,441,-44,857,71520,0.99
120,441,-44,916,72436,0.99
121,441,-44,928,73364,0.99
122,441,-44,917,74281,0.99
123,441,-44,926,75207,0.99
124,441,-44,893,76100,0.99
125,441,-44,848,76948,0.99
126,441,-44,971,77919,0.99
127,441,-44,895,78814,0.99
128,441,-44,958,79772,0.99
129,441,-44,894,80666,0.99
130,441,-44,910,81576,0.99
131,441,-44,899,82475,0.99
132,441,-44,883,83358,0.99
133,441,-44,949,84307,0.99
134,441,-44,909,85216,0.99
135,441,-44,914,86130,0.99
136,441,-44,993,87123,0.99
137,441,-44,1038,88161,0.99
138,441,-44,1032,89193,0.99
139,441,-44,997,90190,0.99
140,441,-44,936,91126,0.99
141,441,-44,971,92097,0.99
142,441,-44,907,93004,0.99
143,441,-44,1001,94005,0.99
144,441,-44,1036,95041,0.99
145,441,-44,986,96027,0.99
146,441,-44,952,96979,0.99
147,441,-44,972,97951,0.99
148,441,-44,965,98916,0.99
149,441,-44,955,99871,0.99
150,441,-44,969,100840,0.99
151,441,-44,941,101781,0.99
152,441,-44,1011,102792,0.99
153,441,-44,983,103775,0.99
154,441,-44,978,104753,0.99
155,441,-44,967,105720,0.99
156,441,-44,950,106670,0.99
157,441,-44,977,107647,0.99
158,441,-44,987,108634,0.99
159,441,-44,972,109606,0.99
160,441,-44,983,110589,0.99
161,441,-44,1094,111683,0.99
162,441,-44,1087,112770,0.99
163,441,-44,1022,113792,0.99
164,441,-44,1042,114834,0.99
165,441,-44,1026,115860,0.99
166,441,-44,1003,116863,0.99
167,441,-44,1007,117870,0.99
168,441,-44,1017,118887,0.99
169,441,-44,1009,119896,0.99
170,441,-44,1041,120937,0.99
171,441,-44,1059,121996,0.99
172,441,-44,1050,123046,0.99
173,441,-44,1086,124132,0.99
174,441,-44,1049,125181,0.99
175,441,-44,1069,126250,0.99
176,441,-44,1131,127381,0.99
177,441,-44,1050,128431,0.99
178,441,-44,1189,129620,0.99
179,441,-44,1117,130737,0.99
180,441,-44,1058,131795,0.99
181,441,-44,1081,132876,0.99
182,441,-44,1142,134018,0.99
183,441,-44,1101,135119,0.99
184,441,-44,1071,136190,0.99
185,441,-44,1069,137259,0.99
186,441,-44,1084,138343,0.99
187,441,-44,1068,139411,0.99
188,441,-44,1073,140484,0.99
189,441,-44,1046,141530,0.99
190,441,-44,1094,142624,0.99
191,441,-44,1065,143689,0.99
192,441,-44,1058,144747,0.99
193,441,-44,1065,145812,0.99
194,441,-44,1038,146850,0.99
195,441,-44,1139,147989,0.99
196,441,-44,1172,149161,0.99
197,441,-44,1130,150291,0.99
198,441,-44,1167,151458,0.99
199,441,-44,1128,152586,0.99
200,441,-44,1226,153812,0.99
201,441,-44,1100,154912,0.99
202,441,-44,1107,156019,0.99
203,441,-44,1121,157140,0.99
204,441,-44,1128,158268,0.99
205,441,-44,1263,159531,0.99
206,441,-44,1115,160646,0.99
207,441,-44,1108,161754,0.99
208,441,-44,1120,162874,0.99
209,441,-44,1112,163986,0.99
210,441,-44,1155,165141,0.99
211,441,-44,1152,166293,0.99
212,441,-44,1134,167427,0.99
213,441,-44,1144,168571,0.99
214,441,-44,1128,169699,0.99
215,441,-44,1174,170873,0.99
216,441,-44,1301,172174,0.99
217,441,-44,1205,173379,0.99
218,441,-44,1222,174601,0.99
219,441,-44,1138,175739,0.99
220,441,-44,1165,176904,0.99
221,441,-44,1229,178133,0.99
222,441,-44,1179,179312,0.99
223,441,-44,1276,180588,0.99
224,441,-44,1285,181873,0.99
225,441,-44,1685,183558,0.99
226,441,-44,1199,184757,0.99
227,441,-44,1145,185902,0.99
228,441,-44,1146,187048,0.99
229,441,-44,1188,188236,0.99
230,441,-44,1198,189434,0.99
231,441,-44,1213,190647,0.99
232,441,-44,1213,191860,0.99
233,441,-44,1261,193121,0.99
234,441,-44,1269,194390,0.99
235,441,-44,1181,195571,0.99
236,441,-44,1194,196765,0.99
237,441,-44,1241,198006,0.99
238,441,-44,1202,199208,0.99
239,441,-44,1200,200408,0.99
240,441,-44,1165,201573,0.99
241,441,-44,1276,202849,0.99
242,441,-44,1176,204025,0.99
243,441,-44,1373,205398,0.99
244,441,-44,1250,206648,0.99
245,441,-44,1173,207821,0.99
246,441,-44,1171,208992,0.99
247,441,-44,1145,210137,0.99
248,441,-44,1172,211309,0.99
249,441,-44.9,1203,212512,0.99
250,441,-44,1168,213680,0.99
251,441,-44,1185,214865,0.99
252,441,-44,1190,216055,0.99
253,441,-44,1217,217272,0.99
254,441,-44,1155,218427,0.99
255,441,-44,1279,219706,0.99
256,441,-44,1214,220920,0.99
257,441,-44,1210,222130,0.99
258,441,-44,1193,223323,0.99
259,441,-44,1229,224552,0.99
260,441,-44,1205,225757,0.99
261,441,-48.8,1193,226950,0.99
262,441,-44,1285,228235,0.99
263,441,-44,1187,229422,0.99
264,441,-44,1219,230641,0.99
265,441,-44,1275,231916,0.99
266,441,-44,1345,233261,0.99
267,441,-44,1212,234473,0.99
268,441,-44,1199,235672,0.99
269,441,-44,1244,236916,0.99
270,441,-44,1199,238115,0.99
271,441,-44,1232,239347,0.99
272,441,-44,1236,240583,0.99
273,441,-44,1290,241873,0.99
274,441,-44,1206,243079,0.99
275,441,-44,1226,244305,0.99
276,441,-44,1249,245554,0.99
277,441,-44,1247,246801,0.99
278,441,-44,1220,248021,0.99
279,441,-44,1261,249282,0.99
280,441,-44,1188,250470,0.99
281,441,-44,1254,251724,0.99
282,441,-44,1248,252972,0.99
283,441,-44,1280,254252,0.99
284,441,-44,1285,255537,0.99
285,441,-44,1236,256773,0.99
286,441,-44,1253,258026,0.99
287,441,-44,1218,259244,0.99
288,441,-44,1264,260508,0.99
289,441,-44,1304,261812,0.99
290,441,-49.7,1223,263035,0.99
291,441,-44,1289,264324,0.99
292,441,-44,1254,265578,0.99
293,441,-44,1231,266809,0.99
294,441,-44,1277,268086,0.99
295,441,-44,1253,269339,0.99
296,441,-44,1259,270598,0.99
297,441,-44,1293,271891,0.99
298,441,-44,1251,273142,0.99
299,441,-44,1255,274397,0.99
300,441,-44,1239,275636,0.99
301,441,-44,1280,276916,0.99
302,441,-44,1266,278182,0.99
303,441,-44,1290,279472,0.99
304,441,-44,1282,280754,0.99
305,441,-44,1287,282041,0.99
306,441,-44,1316,283357,0.99
307,441,-44,1317,284674,0.99
308,441,-44,1278,285952,0.99
309,441,-44,1291,287243,0.99
310,441,-60.1,1260,288503,0.99
311,441,-44,1276,289779,0.99
312,441,-44,1265,291044,0.99
313,441,-44,1259,292303,0.99
314,441,-44,1230,293533,0.99
315,441,-44,1336,294869,0.99
316,441,-44,1273,296142,0.99
317,441,-44,1297,297439,0.99
318,441,-44,1284,298723,0.99
319,441,-44,1312,300035,0.99
320,441,-44,1321,301356,0.99
321,441,-44,1376,302732,0.99
322,441,-51.6,1312,304044,0.99
323,441,-44,1337,305381,0.99
324,441,-44,1346,306727,0.99
325,441,-44,1348,308075,0.99
326,441,-44,1383,309458,0.99
327,441,-44,1345,310803,0.99
328,441,-44,1494,312297,0.99
329,441,-49.7,1396,313693,0.99
330,323,-32.2,1554,315247,0.99
331,441,-44,1564,316811,0.99
332,441,-44,1411,318222,0.99
333,441,-44,1423,319645,0.99
334,441,-44,1565,321210,0.99
335,441,-44,1435,322645,0.99
336,441,-44,1398,324043,0.99
337,441,-44,1415,325458,0.99
338,441,-44,1397,326855,0.99
339,441,-44,1425,328280,0.99
340,441,-44,1438,329718,0.99
341,441,-44,1418,331136,0.99
342,441,-44,1454,332590,0.99
343,441,-44,1402,333992,0.99
344,441,-44,1449,335441,0.99
345,441,-44,1470,336911,0.99
346,441,-44,1398,338309,0.99
347,441,-44,1411,339720,0.99
348,441,-44,1414,341134,0.99
349,441,-44,1409,342543,0.99
350,441,-44,1415,343958,0.99
351,441,-44,1427,345385,0.99
352,441,-44,1391,346776,0.99
353,441,-44,1427,348203,0.99
354,441,-44,1437,349640,0.99
355,441,-44,1421,351061,0.99
356,441,-44,1487,352548,0.99
357,441,-44,1484,354032,0.99
358,441,-44,1375,355407,0.99
359,441,-44,1486,356893,0.99
360,441,-44,1472,358365,0.99
361,441,-44,1635,360000,0.99
362,441,-44,1517,361517,0.99
363,441,-44,1524,363041,0.99
364,441,-44,1651,364692,0.99
365,441,-44,1509,366201,0.99
366,441,-44,1478,367679,0.99
367,441,-45.9,1565,369244,0.99
368,441,-44,1459,370703,0.99
369,441,-44,1434,372137,0.99
370,441,-44,1483,373620,0.99
371,441,-44,1492,375112,0.99
372,441,-44,1664,376776,0.99
373,441,-44,1523,378299,0.99
374,441,-44,1728,380027,0.99
375,441,-44,1693,381720,0.99
376,441,-44,1783,383503,0.99
377,290,-33.6,1550,385053,0.99
378,441,-44,1828,386881,0.99
379,441,-44,1687,388568,0.99
380,441,-44,1943,390511,0.99
381,441,-44,2396,392907,0.99
382,441,-44,1542,394449,0.99
383,441,-44,1505,395954,0.99
384,441,-45.9,1450,397404,0.99
385,441,-44,1523,398927,0.99
386,441,-44,1637,400564,0.99
387,441,-44,1479,402043,0.99
388,441,-44,1544,403587,0.99
389,441,-44,1489,405076,0.99
390,441,-44,1510,406586,0.99
391,441,-44,1588,408174,0.99
392,441,-44,1630,409804,0.99
393,441,-44,1668,411472,0.99
394,441,-44,1730,413202,0.99
395,441,-44,1555,414757,0.99
396,441,-44,1579,416336,0.99
397,441,-44,1606,417942,0.99
398,441,-44,1438,419380,0.99
399,441,-44.9,1430,420810,0.99
400,441,-44,1503,422313,0.99
401,441,-44,1430,423743,0.99
402,441,-44,1463,425206,0.99
403,441,-44,1417,426623,0.99
404,441,-44,1441,428064,0.99
405,441,-44,1389,429453,0.99
406,441,-44,1428,430881,0.99
407,441,-44,1481,432362,0.99
408,441,-44,1527,433889,0.99
409,441,-44,1677,435566,0.99
410,441,-44,1452,437018,0.99
411,441,-44,1500,438518,0.99
412,441,-44,1542,440060,0.99
413,441,-44,1448,441508,0.99
414,441,-44,1460,442968,0.99
415,441,-44,1468,444436,0.99
416,441,-44,1463,445899,0.99
417,441,-44,1478,447377,0.99
418,441,-44,1513,448890,0.99
419,441,-48.6,1510,450400,0.99
420,441,-44,1487,451887,0.99
421,441,-44,1540,453427,0.99
422,441,-45.9,1541,454968,0.99
423,441,-44,1508,456476,0.99
424,441,-44,1471,457947,0.99
425,441,-44,1588,459535,0.99
426,441,-48.5,1603,461138,0.99
427,341,-38.7,1543,462681,0.99
428,441,-44,1614,464295,0.99
429,441,-55.4,1512,465807,0.99
430,441,-44,1477,467284,0.99
431,441,-44,1510,468794,0.99
432,441,-44,1457,470251,0.99
433,441,-46.7,1463,471714,0.99
434,441,-44,1576,473290,0.99
435,441,-44,1746,475036,0.99
436,441,-44,1519,476555,0.99
437,441,-44,1530,478085,0.99
438,324,-32.3,1493,479578,0.99
439,441,-44,1538,481116,0.99
440,441,-44,1604,482720,0.99
441,388,-39.6,1529,484249,0.99
442,441,-44,1666,485915,0.99
443,441,-44,1660,487575,0.99
444,376,-38.4,1482,489057,0.99
445,441,-44,1507,490564,0.99
446,441,-44,1586,492150,0.99
447,441,-44,1487,493637,0.99
448,441,-44,1603,495240,0.99
449,441,-44,1586,496826,0.99
450,441,-44,1477,498303,0.99
451,441,-44,1698,500001,0.99
452,441,-44,1550,501551,0.99
453,441,-57.3,1737,503288,0.99
454,441,-44,1526,504814,0.99
455,441,-44,1583,506397,0.99
456,441,-44,1504,507901,0.99
457,441,-47.6,1540,509441,0.99
458,441,-44,1508,510949,0.99
459,441,-44,1493,512442,0.99
460,441,-44,1548,513990,0.99
461,441,-44,1598,515588,0.99
462,441,-44,1532,517120,0.99
463,441,-44,1642,518762,0.99
464,441,-44,1558,520320,0.99
465,441,-44,1687,522007,0.99
466,441,-44,1586,523593,0.99
467,441,-44,1503,525096,0.99
468,441,-44,1574,526670,0.99
469,441,-44,1676,528346,0.99
470,441,-44,1753,530099,0.99
471,441,-44,1508,531607,0.99
472,441,-44,1545,533152,0.99
473,441,-44,1555,534707,0.99
474,408,-45.4,1499,536206,0.99
475,441,-44,1492,537698,0.99
476,361,-36,1525,539223,0.99
477,441,-44,1513,540736,0.99
478,441,-47.8,1751,542487,0.99
479,441,-44,1601,544088,0.99
480,441,-44,1573,545661,0.99
481,441,-44,1607,547268,0.99
482,441,-44,1541,548809,0.99
483,316,-35.1,1599,550408,0.99
484,249,-26.6,1657,552065,0.99
485,342,-34.1,1570,553635,0.99
486,441,-44,1486,555121,0.99
487,441,-44,1554,556675,0.99
488,378,-39.5,1524,558199,0.99
489,227,-22.6,1507,559706,0.99
490,441,-44,1545,561251,0.99
491,441,-44,1526,562777,0.99
492,441,-44,1485,564262,0.99
493,441,-44,1548,565810,0.99
494,441,-44,1507,567317,0.99
495,305,-30.4,1522,568839,0.99
496,441,-44,1523,570362,0.99
497,428,-43.6,1518,571880,0.99
498,441,-44,1514,573394,0.99
499,441,-45.8,1518,574912,0.99
500,441,-44,1563,576475,0.99
501,441,-44,1494,577969,0.99
502,441,-44,1525,579494,0.99
503,251,-26.8,1508,581002,0.99
504,441,-44,1520,582522,0.99
505,441,-44,1496,584018,0.99
506,441,-48.7,1513,585531,0.99
507,441,-44,1530,587061,0.99
508,441,-44,1530,588591,0.99
509,351,-35,1558,590149,0.99
510,441,-44,1516,591665,0.99
511,441,-44,1476,593141,0.99
512,441,-51.6,1540,594681,0.99
513,260,-30.4,1544,596225,0.99
514,441,-49.8,1510,597735,0.99
515,441,-44,1567,599302,0.99
516,441,-49.7,1490,600792,0.99
517,205,-20.4,1528,602320,0.99
518,441,-44,1542,603862,0.99
519,441,-44,1601,605463,0.99
520,441,-44,1599,607062,0.99
521,374,-37.3,1580,608642,0.99
522,441,-45.9,1579,610221,0.99
523,441,-44,1663,611884,0.99
524,441,-44,1625,613509,0.99
525,161,-16,1607,615116,0.99
526,441,-44,1620,616736,0.99
527,441,-44,1683,618419,0.99
528,441,-44,1686,620105,0.99
529,441,-44,1638,621743,0.99
530,393,-39.2,1569,623312,0.99
531,254,-25.3,1635,624947,0.99
532,441,-44,1585,626532,0.99
533,441,-45.9,1584,628116,0.99
534,270,-27.8,1622,629738,0.99
535,160,-16.8,1620,631358,0.99
536,441,-44,1633,632991,0.99
537,441,-95.3,1570,634561,0.99
538,441,-44,1610,636171,0.99
539,188,-18.7,1579,637750,0.99
540,240,-25.7,1595,639345,0.99
541,441,-44,1620,640965,0.99
542,441,-45.9,1614,642579,0.99
543,441,-44,1599,644178,0.99
544,441,-44,1633,645811,0.99
545,441,-44,1585,647396,0.99
546,138,-13.7,1646,649042,0.99
547,441,-44,1736,650778,0.99
548,441,-44,1718,652496,0.99
549,441,-44,1630,654126,0.99
550,441,-44,1640,655766,0.99
551,284,-28.3,1672,657438,0.99
552,441,-44,1681,659119,0.99
553,441,-44,1686,660805,0.99
554,403,-40.2,1623,662428,0.99
555,441,-44,1596,664024,0.99
556,322,-32.1,1617,665641,0.99
557,441,-44,1599,667240,0.99
558,441,-44,1635,668875,0.99
559,441,-44,1583,670458,0.99
560,441,-44,1577,672035,0.99
561,161,-16.9,1576,673611,0.99
562,371,-39.7,1642,675253,0.99
563,276,-27.5,1628,676881,0.99
564,441,-44,1616,678497,0.99
565,197,-19.6,1645,680142,0.99
566,149,-14.8,1616,681758,0.99
567,441,-44,1624,683382,0.99
568,441,-45.9,1608,684990,0.99
569,441,-44,1639,686629,0.99
570,441,-44,1617,688246,0.99
571,441,-44,1632,689878,0.99
572,441,-44,1625,691503,0.99
573,214,-22.2,1613,693116,0.99
574,441,-44,1613,694729,0.99
575,441,-44,1618,696347,0.99
576,441,-44,1604,697951,0.99
577,441,-44,1635,699586,0.99
578,441,-50.3,1619,701205,0.99
579,290,-28.9,1634,702839,0.99
580,296,-29.5,1658,704497,0.99
581,441,-44,1596,706093,0.99
582,441,-44,1619,707712,0.99
583,441,-44,1613,709325,0.99
584,197,-20.5,1606,710931,0.99
585,441,-44,1632,712563,0.99
586,179,-17.8,1607,714170,0.99
587,411,-41,1654,715824,0.99
588,149,-14.8,1677,717501,0.99
589,285,-30.2,1629,719130,0.99
590,441,-44,1591,720721,0.99
591,113,-12.1,1619,722340,0.99
592,441,-44,1632,723972,0.99
593,441,-44,1662,725634,0.99
594,148,-14.7,1631,727265,0.99
595,243,-24.2,1664,728929,0.99
596,441,-44.9,1619,730548,0.99
597,232,-24,1665,732213,0.99
598,171,-17,1624,733837,0.99
599,441,-44,1668,735505,0.99
600,177,-18.5,1682,737187,0.99
601,440,-43.9,1650,738837,0.99
602,441,-44,1676,740513,0.99
603,146,-14.5,1702,742215,0.99
604,378,-37.7,1641,743856,0.99
605,441,-44,1623,745479,0.99
606,242,-24.1,1622,747101,0.99
607,441,-44,1647,748748,0.99
608,441,-44,1672,750420,0.99
609,233,-23.2,1656,752076,0.99
610,116,-11.5,1689,753765,0.99
611,441,-44,1678,755443,0.99
612,213,-21.2,1641,757084,0.99
613,441,-44,1652,758736,0.99
614,441,-44,1649,760385,0.99
615,441,-44,1618,762003,0.99
616,128,-12.7,1639,763642,0.99
617,216,-21.5,1650,765292,0.99
618,441,-44,1646,766938,0.99
619,139,-13.8,1710,768648,0.99
620,441,-44,1691,770339,0.99
621,308,-30.7,1661,772000,0.99
622,193,-19.2,1649,773649,0.99
623,125,-13.3,1628,775277,0.99
624,336,-33.5,1678,776955,0.99
625,441,-44.9,1667,778622,0.99
626,168,-16.7,1684,780306,0.99
627,441,-44,1647,781953,0.99
628,441,-44,1688,783641,0.99
629,102,-10.1,1645,785286,0.99
630,89,-9.7,1664,786950,0.99
631,441,-44,1682,788632,0.99
632,104,-11.2,1610,790242,0.99
633,441,-44,1673,791915,0.99
634,138,-13.7,1665,793580,0.99
635,313,-31.2,1679,795259,0.99
636,174,-17.3,1688,796947,0.99
637,441,-44,1638,798585,0.99
638,142,-14.1,1663,800248,0.99
639,441,-44,1703,801951,0.99
640,441,-44,1690,803641,0.99
641,441,-44,1676,805317,0.99
642,441,-44,1625,806942,0.99
643,122,-12.1,1677,808619,0.99
644,441,-44,1691,810310,0.99
645,101,-10,1816,812126,0.99
646,101,-10.9,1808,813934,0.99
647,127,-12.6,1877,815811,0.99
648,441,-44,1678,817489,0.99
649,246,-24.5,1712,819201,0.99
650,240,-23.9,1813,821014,0.99
651,122,-12.1,1726,822740,0.99
652,132,-14,1742,824482,0.99
653,147,-14.6,1776,826258,0.99
654,167,-17.5,1908,828166,0.99
655,441,-44,1779,829945,0.99
656,131,-13,1812,831757,0.99
657,441,-44,1716,833473,0.99
658,283,-28.2,1792,835265,0.99
659,363,-38.9,1823,837088,0.99
660,110,-10.9,1883,838971,0.99
661,441,-44,1750,840721,0.99
662,363,-40,1795,842516,0.99
663,150,-16.7,1797,844313,0.99
664,441,-44,1805,846118,0.99
665,441,-47.8,1725,847843,0.99
666,143,-14.2,1782,849625,0.99
667,113,-13,1687,851312,0.99
668,226,-22.5,1690,853002,0.99
669,441,-44,1706,854708,0.99
670,141,-14,1667,856375,0.99
671,378,-37.7,1747,858122,0.99
672,94,-9.3,1751,859873,0.99
673,123,-13.1,1680,861553,0.99
674,103,-10.2,1672,863225,0.99
675,107,-10.6,1798,865023,0.99
676,441,-48.5,1770,866793,0.99
677,186,-18.5,2013,868806,0.99
678,376,-37.5,1776,870582,0.99
679,381,-38,1860,872442,0.99
680,441,-44,1762,874204,0.99
681,101,-11.8,1778,875982,0.99
682,441,-44,1756,877738,0.99
683,196,-26.1,1884,879622,0.99
684,338,-33.7,2026,881648,0.99
685,110,-10.9,1812,883460,0.99
686,418,-41.7,1868,885328,0.99
687,235,-23.4,1791,887119,0.99
688,204,-20.3,1789,888908,0.99
689,273,-27.2,1934,890842,0.99
690,441,-44,1776,892618,0.99
691,135,-14.3,1755,894373,0.99
692,421,-42,1801,896174,0.99
693,175,-17.4,1806,897980,0.99
694,441,-44,1781,899761,0.99
695,203,-20.2,1731,901492,0.99
696,159,-15.8,1760,903252,0.99
697,123,-12.2,1764,905016,0.99
698,226,-22.5,1718,906734,0.99
699,249,-24.8,1753,908487,0.99
700,240,-23.9,1738,910225,0.99
701,441,-44,1765,911990,0.99
702,123,-12.2,1755,913745,0.99
703,441,-44,1782,915527,0.99
704,122,-13.9,1791,917318,0.99
705,202,-20.1,1731,919049,0.99
706,108,-10.7,1775,920824,0.99
707,152,-15.1,1768,922592,0.99
708,124,-13.2,1762,924354,0.99
709,138,-15.5,1733,926087,0.99
710,167,-16.6,1788,927875,0.99
711,441,-44,1744,929619,0.99
712,441,-44.9,1740,931359,0.99
713,441,-44,1752,933111,0.99
714,203,-20.2,1796,934907,0.99
715,441,-44,1773,936680,0.99
716,123,-12.2,2174,938854,0.99
717,441,-44,2141,940995,0.99
718,110,-11.8,1892,942887,0.99
719,441,-44,1835,944722,0.99
720,149,-14.8,1788,946510,0.99
721,181,-18.9,2105,948615,0.99
722,441,-44,1976,950591,0.99
723,230,-24.7,1802,952393,0.99
724,130,-14.7,1806,954199,0.99
725,150,-14.9,1963,956162,0.99
726,103,-10.2,1797,957959,0.99
727,148,-15.6,1804,959763,0.99
728,153,-15.2,1773,961536,0.99
729,138,-15.5,1831,963367,0.99
730,210,-20.9,1790,965157,0.99
731,107,-10.6,1787,966944,0.99
732,114,-12.2,1779,968723,0.99
733,191,-19,1781,970504,0.99
734,433,-45,1757,972261,0.99
735,441,-44,1807,974068,0.99
736,109,-10.8,1795,975863,0.99
737,286,-28.5,1765,977628,0.99
738,153,-17,1792,979420,0.99
739,441,-44,1792,981212,0.99
740,115,-11.4,1737,982949,0.99
741,101,-10,1815,984764,0.99
742,441,-44,1737,986501,0.99
743,129,-12.8,1754,988255,0.99
744,148,-14.7,1763,990018,0.99
745,96,-10.4,1900,991918,0.99
746,142,-14.1,1795,993713,0.99
747,134,-13.3,1787,995500,0.99
748,106,-11.4,1749,997249,0.99
749,158,-15.7,1777,999026,0.99
750,94,-9.3,1792,1000818,0.99
751,160,-15.9,1748,1002566,0.99
752,441,-44,1810,1004376,0.99
753,362,-36.1,1782,1006158,0.99
754,91,-9,1781,1007939,0.99
755,207,-21.5,1805,1009744,0.99
756,126,-14.3,1780,1011524,0.99
757,127,-13.5,1762,1013286,0.99
758,253,-27.1,1796,1015082,0.99
759,119,-11.8,1812,1016894,0.99
760,441,-44,1795,1018689,0.99
761,170,-18.7,1757,1020446,0.99
762,162,-17,1792,1022238,0.99
763,441,-44,1755,1023993,0.99
764,115,-11.4,1821,1025814,0.99
765,441,-44,1820,1027634,0.99
766,324,-32.3,1805,1029439,0.99
767,232,-23.1,1801,1031240,0.99
768,102,-10.1,1759,1032999,0.99
769,97,-10.5,1775,1034774,0.99
770,441,-44,1769,1036543,0.99
771,441,-44,1827,1038370,0.99
772,121,-12.9,1821,1040191,0.99
773,108,-10.7,1785,1041976,0.99
774,162,-16.1,1775,1043751,0.99
775,441,-44,1784,1045535,0.99
776,187,-18.6,1771,1047306,0.99
777,139,-13.8,1808,1049114,0.99
778,137,-13.6,1801,1050915,0.99
779,120,-11.9,1812,1052727,0.99
780,131,-13,1803,1054530,0.99
781,441,-44,1767,1056297,0.99
782,441,-44,1782,1058079,0.99
783,157,-16.5,1833,1059912,0.99
784,248,-29.2,1761,1061673,0.99
785,306,-31.4,1739,1063412,0.99
786,103,-10.2,1746,1065158,0.99
787,441,-44,1764,1066922,0.99
788,441,-44,1768,1068690,0.99
789,112,-11.1,1855,1070545,0.99
790,378,-38.6,1742,1072287,0.99
791,145,-15.3,1778,1074065,0.99
792,102,-10.1,1794,1075859,0.99
793,98,-9.7,1810,1077669,0.99
794,441,-44,1768,1079437,0.99
795,204,-21.2,1820,1081257,0.99
796,174,-18.2,1905,1083162,0.99
797,290,-28.9,1812,1084974,0.99
798,207,-20.6,1823,1086797,0.99
799,168,-16.7,1813,1088610,0.99
800,304,-30.3,1801,1090411,0.99
801,141,-14,1796,1092207,0.99
802,112,-12,1811,1094018,0.99
803,441,-44,1777,1095795,0.99
804,202,-21,1823,1097618,0.99
805,123,-12.2,1836,1099454,0.99
806,441,-44,1761,1101215,0.99
807,92,-9.1,1753,1102968,0.99
808,441,-44,1817,1104785,0.99
809,105,-10.4,1765,1106550,0.99
810,97,-9.6,1797,1108347,0.99
811,441,-44,1785,1110132,0.99
812,210,-20.9,1782,1111914,0.99
813,114,-11.3,1783,1113697,0.99
814,108,-10.7,1835,1115532,0.99
815,441,-44,1801,1117333,0.99
816,188,-18.7,1819,1119152,0.99
817,101,-10,1824,1120976,0.99
818,157,-17.4,1783,1122759,0.99
819,171,-17,1768,1124527,0.99
820,123,-12.2,1778,1126305,0.99
821,125,-14.2,1787,1128092,0.99
822,441,-44,1824,1129916,0.99
823,144,-14.3,1789,1131705,0.99
824,103,-10.2,1821,1133526,0.99
825,215,-21.4,1856,1135382,0.99
826,441,-44,1786,1137168,0.99
827,101,-10,1894,1139062,0.99
828,157,-15.6,1855,1140917,0.99
829,441,-44,1836,1142753,0.99
830,441,-44,1821,1144574,0.99
831,246,-24.5,1822,1146396,0.99
832,91,-9,1827,1148223,0.99
833,118,-13.5,1819,1150042,0.99
834,194,-19.3,1808,1151850,0.99
835,441,-44,1803,1153653,0.99
836,103,-10.2,1865,1155518,0.99
837,173,-19,1831,1157349,0.99
838,112,-13.8,1809,1159158,0.99
839,102,-10.1,1804,1160962,0.99
840,93,-9.2,1812,1162774,0.99
841,101,-10,1812,1164586,0.99
842,105,-11.3,1841,1166427,0.99
843,211,-21.9,1835,1168262,0.99
844,104,-10.3,1852,1170114,0.99
845,128,-12.7,1812,1171926,0.99
846,425,-42.4,1816,1173742,0.99
847,441,-44,1852,1175594,0.99
848,97,-9.6,1864,1177458,0.99
849,187,-19.5,1857,1179315,0.99
850,96,-9.5,1810,1181125,0.99
851,158,-15.7,1840,1182965,0.99
852,144,-14.3,1852,1184817,0.99
853,184,-18.3,1832,1186649,0.99
854,104,-11.2,1826,1188475,0.99
855,117,-11.6,1792,1190267,0.99
856,103,-10.2,1838,1192105,0.99
857,103,-10.2,1783,1193888,0.99
858,441,-44,1822,1195710,0.99
859,93,-10.1,1816,1197526,0.99
860,441,-44,1849,1199375,0.99
861,112,-12,1848,1201223,0.99
862,104,-10.3,1860,1203083,0.99
863,105,-10.4,1865,1204948,0.99
864,179,-17.8,1837,1206785,0.99
865,101,-10,1822,1208607,0.99
866,166,-18.3,1842,1210449,0.99
867,140,-16.6,1844,1212293,0.99
868,128,-12.7,1807,1214100,0.99
869,127,-12.6,1809,1215909,0.99
870,102,-10.1,1828,1217737,0.99
871,104,-12.1,1840,1219577,0.99
872,140,-14.8,1865,1221442,0.99
873,105,-11.3,1871,1223313,0.99
874,156,-15.5,1901,1225214,0.99
875,105,-10.4,1857,1227071,0.99
876,203,-20.2,1863,1228934,0.99
877,103,-10.2,1851,1230785,0.99
878,105,-10.4,1864,1232649,0.99
879,290,-28.9,1899,1234548,0.99
880,102,-11,1862,1236410,0.99
881,174,-17.3,1829,1238239,0.99
882,224,-22.3,1899,1240138,0.99
883,166,-16.5,1929,1242067,0.99
884,183,-18.2,1979,1244046,0.99
885,98,-9.7,1921,1245967,0.99
886,99,-9.8,1884,1247851,0.99
887,103,-10.2,1885,1249736,0.99
888,114,-11.3,1923,1251659,0.99
889,104,-10.3,1828,1253487,0.99
890,255,-29.2,1847,1255334,0.99
891,139,-13.8,1861,1257195,0.99
892,94,-9.3,1849,1259044,0.99
893,97,-9.6,1803,1260847,0.99
894,441,-44,1845,1262692,0.99
895,441,-53.6,1822,1264514,0.99
896,441,-44,1821,1266335,0.99
897,112,-12.9,1855,1268190,0.99
898,441,-44,1883,1270073,0.99
899,113,-12.1,1849,1271922,0.99
900,124,-13.2,1829,1273751,0.99
901,134,-13.3,1884,1275635,0.99
902,105,-12.2,1835,1277470,0.99
903,214,-21.3,1806,1279276,0.99
904,102,-11,1860,1281136,0.99
905,132,-13.1,1829,1282965,0.99
906,96,-9.5,1843,1284808,0.99
907,141,-14,1846,1286654,0.99
908,110,-10.9,1879,1288533,0.99
909,125,-13.3,1829,1290362,0.99
910,178,-18.6,1865,1292227,0.99
911,176,-17.5,1843,1294070,0.99
912,206,-21.4,1874,1295944,0.99
913,167,-16.6,1850,1297794,0.99
914,155,-16.3,1872,1299666,0.99
915,130,-12.9,1860,1301526,0.99
916,105,-10.4,1834,1303360,0.99
917,441,-44,1858,1305218,0.99
918,300,-31.7,1854,1307072,0.99
919,123,-13.1,1855,1308927,0.99
920,107,-10.6,1891,1310818,0.99
921,441,-44,1837,1312655,0.99
922,126,-13.4,1852,1314507,0.99
923,307,-31.5,1865,1316372,0.99
924,397,-39.6,1866,1318238,0.99
925,441,-44,1854,1320092,0.99
926,126,-12.5,1896,1321988,0.99
927,100,-9.9,1896,1323884,0.99
928,103,-10.2,1844,1325728,0.99
929,89,-8.8,1858,1327586,0.99
930,106,-11.4,1850,1329436,0.99
931,207,-20.6,1904,1331340,0.99
932,121,-12,1866,1333206,0.99
933,102,-11,1836,1335042,0.99
934,111,-11,1907,1336949,0.99
935,98,-10.6,1850,1338799,0.99
936,441,-44,1863,1340662,0.99
937,148,-14.7,1882,1342544,0.99
938,362,-36.1,1887,1344431,0.99
939,97,-9.6,1842,1346273,0.99
940,441,-44,1924,1348197,0.99
941,441,-58.5,1843,1350040,0.99
942,114,-11.3,1887,1351927,0.99
943,184,-19.2,1860,1353787,0.99
944,148,-14.7,1879,1355666,0.99
945,106,-10.5,1884,1357550,0.99
946,152,-16,1904,1359454,0.99
947,131,-13.9,1932,1361386,0.99
948,159,-15.8,1891,1363277,0.99
949,131,-13,1864,1365141,0.99
950,98,-9.7,1881,1367022,0.99
951,98,-9.7,1934,1368956,0.99
952,173,-19.1,1888,1370844,0.99
953,133,-13.2,1868,1372712,0.99
954,441,-44,1876,1374588,0.99
955,90,-8.9,1900,1376488,0.99
956,115,-11.4,1865,1378353,0.99
957,126,-12.5,1890,1380243,0.99
958,100,-9.9,1864,1382107,0.99
959,96,-9.5,1909,1384016,0.99
960,126,-12.5,1875,1385891,0.99
961,101,-10,1940,1387831,0.99
962,105,-10.4,1904,1389735,0.99
963,123,-12.2,1876,1391611,0.99
964,227,-22.6,1892,1393503,0.99
965,109,-10.8,1882,1395385,0.99
966,334,-33.3,1900,1397285,0.99
967,114,-11.3,1876,1399161,0.99
968,252,-26,1885,1401046,0.99
969,107,-13.3,1867,1402913,0.99
970,107,-12.4,1881,1404794,0.99
971,441,-44,1899,1406693,0.99
972,100,-10.8,1912,1408605,0.99
973,102,-10.1,1868,1410473,0.99
974,99,-9.8,1895,1412368,0.99
975,97,-9.6,1919,1414287,0.99
976,102,-11,1894,1416181,0.99
977,99,-9.8,1907,1418088,0.99
978,123,-12.2,1923,1420011,0.99
979,124,-13.2,1936,1421947,0.99
980,441,-44,1899,1423846,0.99
981,119,-11.8,1933,1425779,0.99
982,111,-11,1900,1427679,0.99
983,137,-13.6,1892,1429571,0.99
984,385,-38.4,1869,1431440,0.99
985,181,-21.8,1898,1433338,0.99
986,88,-9.6,1896,1435234,0.99
987,301,-30.9,1872,1437106,0.99
988,99,-9.8,1870,1438976,0.99
989,97,-9.6,1857,1440833,0.99
990,109,-10.8,1955,1442788,0.99
991,105,-10.4,1903,1444691,0.99
992,98,-9.7,1909,1446600,0.99
993,102,-10.1,1884,1448484,0.99
994,100,-9.9,1875,1450359,0.99
995,118,-11.7,1885,1452244,0.99
996,115,-13.2,1880,1454124,0.99
997,105,-10.4,1900,1456024,0.99
998,96,-9.5,1946,1457970,0.99
999,288,-28.7,1887,1459857,0.99
1000,104,-10.3,1874,1461731,0.99
1001,101,-10,1869,1463600,0.99
1002,111,-11.9,1877,1465477,0.99
1003,104,-10.3,1906,1467383,0.99
1004,123,-12.2,1900,1469283,0.99
1005,96,-9.5,1846,1471129,0.99
1006,208,-21.6,1917,1473046,0.99
1007,107,-11.5,1922,1474968,0.99
1008,97,-9.6,1911,1476879,0.99
1009,228,-23.6,1870,1478749,0.99
1010,138,-13.7,1908,1480657,0.99
1011,102,-10.1,1892,1482549,0.99
1012,92,-9.1,1930,1484479,0.99
1013,108,-10.7,1931,1486410,0.99
1014,97,-9.6,1886,1488296,0.99
1015,110,-10.9,2000,1490296,0.99
1016,103,-10.2,1910,1492206,0.99
1017,108,-12.5,1887,1494093,0.99
1018,123,-14.9,1875,1495968,0.99
1019,125,-12.4,1866,1497834,0.99
1020,140,-13.9,1921,1499755,0.99
1021,112,-12.9,1927,1501682,0.99
1022,96,-9.5,1957,1503639,0.99
1023,96,-9.5,1892,1505531,0.99
1024,130,-12.9,1893,1507424,0.99
1025,441,-44,1869,1509293,0.99
1026,101,-10,1901,1511194,0.99
1027,207,-22.4,1907,1513101,0.99
1028,163,-17.1,1917,1515018,0.99
1029,135,-13.4,1908,1516926,0.99
1030,119,-11.8,1888,1518814,0.99
1031,128,-12.7,1939,1520753,0.99
1032,116,-11.5,1912,1522665,0.99
1033,101,-10,1920,1524585,0.99
1034,441,-44,1907,1526492,0.99
1035,144,-15.2,1966,1528458,0.99
1036,162,-16.1,1943,1530401,0.99
1037,124,-15,1914,1532315,0.99
1038,100,-9.9,1925,1534240,0.99
1039,105,-10.4,1903,1536143,0.99
1040,124,-12.3,1945,1538088,0.99
1041,257,-25.6,1951,1540039,0.99
1042,122,-13,1965,1542004,0.99
1043,110,-10.9,1903,1543907,0.99
1044,339,-33.8,1957,1545864,0.99
1045,103,-12,1907,1547771,0.99
1046,131,-13,1979,1549750,0.99
1047,145,-15.3,1900,1551650,0.99
1048,122,-12.1,1972,1553622,0.99
1049,354,-79.4,1872,1555494,0.99
1050,99,-9.8,1900,1557394,0.99
1051,102,-10.1,1898,1559292,0.99
1052,107,-11.5,1900,1561192,0.99
1053,98,-9.7,1890,1563082,0.99
1054,102,-10.1,1937,1565019,0.99
1055,97,-9.6,1894,1566913,0.99
1056,128,-14.5,1898,1568811,0.99
1057,111,-11,1906,1570717,0.99
1058,103,-10.2,1884,1572601,0.99
1059,115,-11.4,1887,1574488,0.99
1060,122,-12.1,1932,1576420,0.99
1061,114,-12.2,1893,1578313,0.99
1062,92,-9.1,1889,1580202,0.99
1063,441,-44,1910,1582112,0.99
1064,107,-10.6,1897,1584009,0.99
1065,123,-12.2,1935,1585944,0.99
1066,98,-9.7,1915,1587859,0.99
1067,102,-11,1951,1589810,0.99
1068,95,-10.3,1899,1591709,0.99
1069,101,-10,1921,1593630,0.99
1070,108,-14.3,1929,1595559,0.99
1071,96,-9.5,1916,1597475,0.99
1072,99,-9.8,1914,1599389,0.99
1073,114,-11.3,1915,1601304,0.99
1074,112,-11.1,1890,1603194,0.99
1075,105,-10.4,1925,1605119,0.99
1076,109,-10.8,1950,1607069,0.99
1077,111,-11,1973,1609042,0.99
1078,441,-44,1916,1610958,0.99
1079,101,-10,1924,1612882,0.99
1080,101,-10,1956,1614838,0.99
1081,441,-44,1938,1616776,0.99
1082,101,-10,1941,1618717,0.99
1083,441,-44,1967,1620684,0.99
1084,149,-14.8,1933,1622617,0.99
1085,109,-10.8,1934,1624551,0.99
1086,95,-9.4,1908,1626459,0.99
1087,111,-11.9,1942,1628401,0.99
1088,102,-10.1,1904,1630305,0.99
1089,100,-9.9,1905,1632210,0.99
1090,97,-9.6,1960,1634170,0.99
1091,135,-16.1,1927,1636097,0.99
1092,94,-11.1,1938,1638035,0.99
1093,98,-9.7,1941,1639976,0.99
1094,98,-9.7,1947,1641923,0.99
1095,111,-11,1909,1643832,0.99
1096,123,-12.2,1960,1645792,0.99
1097,129,-12.8,1943,1647735,0.99
1098,156,-15.5,1955,1649690,0.99
1099,98,-9.7,1923,1651613,0.99
1100,105,-10.4,1897,1653510,0.99
1101,112,-11.1,1919,1655429,0.99
1102,123,-12.2,1867,1657296,0.99
1103,140,-14.8,1935,1659231,0.99
1104,247,-24.6,1926,1661157,0.99
1105,106,-13.2,1948,1663105,0.99
1106,102,-10.1,1909,1665014,0.99
1107,99,-10.7,1904,1666918,0.99
1108,97,-9.6,1961,1668879,0.99
1109,103,-11.1,1924,1670803,0.99
1110,117,-11.6,1888,1672691,0.99
1111,441,-44,1921,1674612,0.99
1112,108,-10.7,1968,1676580,0.99
1113,109,-11.7,1955,1678535,0.99
1114,102,-10.1,1913,1680448,0.99
1115,93,-10.1,1953,1682401,0.99
1116,114,-12.2,1924,1684325,0.99
1117,96,-10.4,1956,1686281,0.99
1118,100,-9.9,1919,1688200,0.99
1119,109,-10.8,1928,1690128,0.99
1120,116,-11.5,1931,1692059,0.99
1121,90,-8.9,1896,1693955,0.99
1122,107,-10.6,1915,1695870,0.99
1123,97,-9.6,1914,1697784,0.99
1124,104,-10.3,1959,1699743,0.99
1125,109,-10.8,1915,1701658,0.99
1126,441,-51.6,1932,1703590,0.99
1127,116,-11.5,1945,1705535,0.99
1128,139,-13.8,1931,1707466,0.99
1129,118,-12.6,1971,1709437,0.99
1130,108,-11.6,1947,1711384,0.99
1131,86,-8.5,1914,1713298,0.99
1132,107,-12.4,1930,1715228,0.99
1133,106,-10.5,1943,1717171,0.99
1134,110,-14.5,1892,1719063,0.99
1135,106,-10.5,1943,1721006,0.99
1136,101,-10,1930,1722936,0.99
1137,91,-9,1932,1724868,0.99
1138,99,-10.7,1932,1726800,0.99
1139,121,-12,1933,1728733,0.99
1140,103,-10.2,1945,1730678,0.99
1141,94,-10.2,1970,1732648,0.99
1142,112,-11.1,1932,1734580,0.99
1143,99,-9.8,1964,1736544,0.99
1144,100,-11.7,1936,1738480,0.99
1145,150,-14.9,1937,1740417,0.99
1146,101,-10,1930,1742347,0.99
1147,111,-11.9,1921,1744268,0.99
1148,111,-11,1964,1746232,0.99
1149,153,-15.2,1972,1748204,0.99
1150,93,-9.2,1917,1750121,0.99
1151,110,-10.9,1908,1752029,0.99
1152,108,-12.5,1913,1753942,0.99
1153,101,-10,1950,1755892,0.99
1154,114,-11.3,1915,1757807,0.99
1155,126,-12.5,1901,1759708,0.99
1156,441,-44,1982,1761690,0.99
1157,115,-13.2,1976,1763666,0.99
1158,107,-12.4,1977,1765643,0.99
1159,89,-8.8,1950,1767593,0.99
1160,97,-9.6,1954,1769547,0.99
1161,98,-9.7,1966,1771513,0.99
1162,114,-11.3,1919,1773432,0.99
1163,102,-11,1946,1775378,0.99
1164,141,-14,1970,1777348,0.99
1165,112,-11.1,1981,1779329,0.99
1166,96,-9.5,1957,1781286,0.99
1167,89,-8.8,1977,1783263,0.99
1168,113,-11.2,1958,1785221,0.99
1169,138,-13.7,1978,1787199,0.99
1170,98,-9.7,1924,1789123,0.99
1171,225,-23.3,1912,1791035,0.99
1172,102,-11,1898,1792933,0.99
1173,107,-13.3,1946,1794879,0.99
1174,115,-11.4,1943,1796822,0.99
1175,103,-10.2,1998,1798820,0.99
1176,92,-9.1,1984,1800804,0.99
1177,148,-17.4,1997,1802801,0.99
1178,106,-10.5,1965,1804766,0.99
1179,116,-11.5,1920,1806686,0.99
1180,175,-17.4,1914,1808600,0.99
1181,125,-12.4,1926,1810526,0.99
1182,441,-45.8,1933,1812459,0.99
1183,101,-10,1935,1814394,0.99
1184,115,-11.4,1935,1816329,0.99
1185,113,-11.2,1992,1818321,0.99
1186,106,-10.5,1995,1820316,0.99
1187,121,-12,1957,1822273,0.99
1188,121,-12,2020,1824293,0.99
1189,177,-17.6,2004,1826297,0.99
1190,94,-9.3,1986,1828283,0.99
1191,93,-9.2,1968,1830251,0.99
1192,95,-9.4,2004,1832255,0.99
1193,103,-10.2,1979,1834234,0.99
1194,100,-9.9,2035,1836269,0.99
1195,441,-46.8,2008,1838277,0.99
1196,113,-11.2,1944,1840221,0.99
1197,139,-13.8,1966,1842187,0.99
1198,119,-13.6,1982,1844169,0.99
1199,95,-9.4,1969,1846138,0.99
1200,107,-11.5,1975,1848113,0.99
1201,110,-10.9,1967,1850080,0.99
1202,103,-10.2,1956,1852036,0.99
1203,441,-47.6,2002,1854038,0.99
1204,238,-24.6,1998,1856036,0.99
1205,91,-9,2003,1858039,0.99
1206,172,-18.9,2028,1860067,0.99
1207,96,-9.5,1985,1862052,0.99
1208,110,-10.9,1947,1863999,0.99
1209,441,-44,2012,1866011,0.99
1210,172,-23.8,2021,1868032,0.99
1211,102,-11,2013,1870045,0.99
1212,122,-12.1,1964,1872009,0.99
1213,103,-10.2,1976,1873985,0.99
1214,103,-10.2,1985,1875970,0.99
1215,441,-44,1980,1877950,0.99
1216,174,-17.3,1997,1879947,0.99
1217,89,-8.8,1998,1881945,0.99
1218,102,-10.1,1988,1883933,0.99
1219,98,-9.7,2037,1885970,0.99
1220,441,-44,1999,1887969,0.99
1221,115,-11.4,1966,1889935,0.99
1222,95,-10.3,1988,1891923,0.99
1223,124,-13.2,1958,1893881,0.99
1224,110,-11.8,1978,1895859,0.99
1225,111,-12.8,1991,1897850,0.99
1226,109,-12.6,2022,1899872,0.99
1227,98,-10.6,1972,1901844,0.99
1228,117,-12.5,1955,1903799,0.99
1229,121,-12,2105,1905904,0.99
1230,441,-44,1994,1907898,0.99
1231,115,-11.4,1961,1909859,0.99
1232,117,-12.5,1966,1911825,0.99
1233,96,-9.5,2009,1913834,0.99
1234,112,-12,2006,1915840,0.99
1235,131,-13,2008,1917848,0.99
1236,101,-10,2003,1919851,0.99
1237,102,-11,2046,1921897,0.99
1238,84,-8.3,2003,1923900,0.99
1239,180,-17.9,1990,1925890,0.99
1240,100,-11.7,1970,1927860,0.99
1241,104,-10.3,1950,1929810,0.99
1242,114,-11.3,1993,1931803,0.99
1243,126,-13.4,2041,1933844,0.99
1244,92,-9.1,2020,1935864,0.99
1245,105,-10.4,1966,1937830,0.99
1246,97,-9.6,2021,1939851,0.99
1247,131,-13,1999,1941850,0.99
1248,122,-12.1,1996,1943846,0.99
1249,113,-12.1,2002,1945848,0.99
1250,139,-13.8,1992,1947840,0.99
1251,99,-9.8,1967,1949807,0.99
1252,144,-14.3,2039,1951846,0.99
1253,124,-13.2,1988,1953834,0.99
1254,111,-12.8,2027,1955861,0.99
1255,441,-44,2048,1957909,0.99
1256,110,-10.9,2002,1959911,0.99
1257,98,-9.7,1949,1961860,0.99
1258,93,-9.2,1956,1963816,0.99
1259,121,-12.9,1987,1965803,0.99
1260,92,-9.1,2041,1967844,0.99
1261,108,-11.6,2016,1969860,0.99
1262,103,-10.2,2004,1971864,0.99
1263,109,-10.8,1995,1973859,0.99
1264,306,-30.5,1983,1975842,0.99
1265,92,-9.1,2021,1977863,0.99
1266,134,-16.9,2026,1979889,0.99
1267,113,-11.2,2027,1981916,0.99
1268,104,-10.3,2024,1983940,0.99
1269,172,-17.1,2002,1985942,0.99
1270,103,-10.2,2031,1987973,0.99
1271,114,-12.2,1989,1989962,0.99
1272,93,-9.2,2008,1991970,0.99
1273,120,-11.9,1989,1993959,0.99
1274,124,-12.3,2099,1996058,0.99
1275,143,-15.1,1990,1998048,0.99
1276,114,-11.3,2039,2000087,0.99
1277,92,-9.1,2025,2002112,0.99
1278,104,-10.3,1994,2004106,0.99
1279,108,-10.7,2010,2006116,0.99
1280,103,-10.2,1991,2008107,0.99
1281,116,-12.4,1972,2010079,0.99
1282,102,-10.1,2042,2012121,0.99
1283,95,-9.4,2043,2014164,0.99
1284,102,-11,2021,2016185,0.99
1285,97,-9.6,1997,2018182,0.99
1286,100,-10.8,2017,2020199,0.99
1287,105,-10.4,1991,2022190,0.99
1288,109,-10.8,2017,2024207,0.99
1289,108,-10.7,2021,2026228,0.99
1290,441,-44,2052,2028280,0.99
1291,98,-9.7,2050,2030330,0.99
1292,108,-11.6,2021,2032351,0.99
1293,90,-8.9,2007,2034358,0.99
1294,105,-10.4,2028,2036386,0.99
1295,133,-13.2,2034,2038420,0.99
1296,133,-14.1,2021,2040441,0.99
1297,145,-14.4,2029,2042470,0.99
1298,135,-13.4,2000,2044470,0.99
1299,194,-21.1,2006,2046476,0.99
1300,123,-13.1,2015,2048491,0.99
1301,156,-15.5,2027,2050518,0.99
1302,135,-13.4,2016,2052534,0.99
1303,108,-10.7,2051,2054585,0.99
1304,114,-11.3,1986,2056571,0.99
1305,107,-10.6,2016,2058587,0.99
1306,131,-13.9,2043,2060630,0.99
1307,152,-15.1,2030,2062660,0.99
1308,99,-10.7,2028,2064688,0.99
1309,130,-12.9,2012,2066700,0.99
1310,135,-13.4,2045,2068745,0.99
1311,122,-13,2022,2070767,0.99
1312,90,-8.9,2057,2072824,0.99
1313,441,-44,2055,2074879,0.99
1314,112,-11.1,2029,2076908,0.99
1315,113,-11.2,1991,2078899,0.99
1316,102,-11,2047,2080946,0.99
1317,110,-10.9,2028,2082974,0.99
1318,96,-10.4,2005,2084979,0.99
1319,261,-26,2069,2087048,0.99
1320,210,-20.9,2012,2089060,0.99
1321,121,-12,2051,2091111,0.99
1322,106,-11.4,1992,2093103,0.99
1323,105,-10.4,2031,2095134,0.99
1324,202,-20.1,2027,2097161,0.99
1325,104,-10.3,2060,2099221,0.99
1326,115,-13.2,2019,2101240,0.99
1327,114,-11.3,2030,2103270,0.99
1328,96,-9.5,2036,2105306,0.99
1329,103,-10.2,2007,2107313,0.99
1330,108,-10.7,2021,2109334,0.99
1331,141,-14.9,2024,2111358,0.99
1332,103,-10.2,2064,2113422,0.99
1333,111,-11,2020,2115442,0.99
1334,160,-16.8,2013,2117455,0.99
1335,110,-10.9,2039,2119494,0.99
1336,95,-9.4,2050,2121544,0.99
1337,111,-12.8,2011,2123555,0.99
1338,193,-21,2034,2125589,0.99
1339,105,-11.3,2056,2127645,0.99
1340,101,-10,2051,2129696,0.99
1341,101,-10,2050,2131746,0.99
1342,119,-11.8,1995,2133741,0.99
1343,100,-9.9,2035,2135776,0.99
1344,123,-13.1,2052,2137828,0.99
1345,106,-10.5,2034,2139862,0.99
1346,105,-10.4,2023,2141885,0.99
1347,131,-15.7,1994,2143879,0.99
1348,88,-8.7,2011,2145890,0.99
1349,196,-19.5,2066,2147956,0.99
1350,118,-11.7,2051,2150007,0.99
1351,114,-11.3,2080,2152087,0.99
1352,131,-13,1995,2154082,0.99
1353,116,-12.4,2065,2156147,0.99
1354,100,-9.9,2012,2158159,0.99
1355,112,-12.9,2035,2160194,0.99
1356,239,-23.8,2077,2162271,0.99
1357,108,-11.6,2024,2164295,0.99
1358,133,-14.1,2070,2166365,0.99
1359,106,-13.2,2059,2168424,0.99
1360,94,-9.3,2069,2170493,0.99
1361,123,-12.2,2076,2172569,0.99
1362,106,-11.4,2083,2174652,0.99
1363,100,-10.8,2019,2176671,0.99
1364,101,-10,2064,2178735,0.99
1365,108,-10.7,2066,2180801,0.99
1366,92,-10,2064,2182865,0.99
1367,112,-11.1,2032,2184897,0.99
1368,128,-12.7,2041,2186938,0.99
1369,103,-12.9,2003,2188941,0.99
1370,108,-10.7,2085,2191026,0.99
1371,211,-21.9,2006,2193032,0.99
1372,114,-12.2,2029,2195061,0.99
1373,113,-11.2,2051,2197112,0.99
1374,97,-9.6,2054,2199166,0.99
1375,109,-10.8,2047,2201213,0.99
1376,95,-9.4,2046,2203259,0.99
1377,112,-13.8,2018,2205277,0.99
1378,118,-13.5,2042,2207319,0.99
1379,94,-9.3,2010,2209329,0.99
1380,157,-30,2065,2211394,0.99
1381,104,-13.9,2030,2213424,0.99
1382,115,-12.3,2023,2215447,0.99
1383,164,-16.3,2079,2217526,0.99
1384,93,-9.2,2070,2219596,0.99
1385,124,-12.3,2107,2221703,0.99
1386,195,-19.4,2067,2223770,0.99
1387,157,-15.6,2092,2225862,0.99
1388,101,-10,2026,2227888,0.99
1389,116,-11.5,2028,2229916,0.99
1390,290,-36.5,2063,2231979,0.99
1391,441,-47.8,2068,2234047,0.99
1392,104,-10.3,2026,2236073,0.99
1393,101,-10,2061,2238134,0.99
1394,101,-10,2080,2240214,0.99
1395,103,-11.1,2059,2242273,0.99
1396,156,-17.3,2128,2244401,0.99
1397,104,-12.1,2069,2246470,0.99
1398,116,-12.4,2072,2248542,0.99
1399,104,-10.3,2050,2250592,0.99
1400,115,-12.3,2091,2252683,0.99
1401,99,-9.8,2083,2254766,0.99
1402,102,-10.1,2060,2256826,0.99
1403,122,-12.1,2068,2258894,0.99
1404,178,-20.4,2042,2260936,0.99
1405,114,-11.3,2087,2263023,0.99
1406,112,-12,2096,2265119,0.99
1407,99,-9.8,2032,2267151,0.99
1408,137,-13.6,2038,2269189,0.99
1409,114,-11.3,2041,2271230,0.99
1410,173,-20.8,2049,2273279,0.99
1411,108,-11.6,2029,2275308,0.99
1412,105,-10.4,1990,2277298,0.99
1413,209,-21.7,2055,2279353,0.99
1414,103,-10.2,2067,2281420,0.99
1415,238,-23.7,2068,2283488,0.99
1416,109,-10.8,2087,2285575,0.99
1417,102,-10.1,2045,2287620,0.99
1418,147,-15.5,2005,2289625,0.99
1419,116,-11.5,2018,2291643,0.99
1420,120,-11.9,2031,2293674,0.99
1421,97,-9.6,2023,2295697,0.99
1422,99,-9.8,2078,2297775,0.99
1423,96,-10.4,2119,2299894,0.99
1424,161,-16.9,2085,2301979,0.99
1425,110,-10.9,2083,2304062,0.99
1426,190,-20.7,2050,2306112,0.99
1427,108,-11.6,2049,2308161,0.99
1428,142,-14.1,2054,2310215,0.99
1429,116,-11.5,2067,2312282,0.99
1430,120,-11.9,2043,2314325,0.99
1431,99,-9.8,2049,2316374,0.99
1432,89,-8.8,2028,2318402,0.99
1433,121,-12,2079,2320481,0.99
1434,107,-10.6,2121,2322602,0.99
1435,92,-9.1,2090,2324692,0.99
1436,101,-10.9,2082,2326774,0.99
1437,102,-10.1,2087,2328861,0.99
1438,106,-10.5,2047,2330908,0.99
1439,111,-11.9,2040,2332948,0.99
1440,107,-10.6,2056,2335004,0.99
1441,94,-9.3,2100,2337104,0.99
1442,110,-10.9,2061,2339165,0.99
1443,199,-19.8,2065,2341230,0.99
1444,95,-9.4,2081,2343311,0.99
1445,105,-11.3,2062,2345373,0.99
1446,120,-12.8,2100,2347473,0.99
1447,103,-10.2,2078,2349551,0.99
1448,184,-20.1,2042,2351593,0.99
1449,107,-11.5,2078,2353671,0.99
1450,96,-9.5,2025,2355696,0.99
1451,183,-19.1,2079,2357775,0.99
1452,99,-10.7,2068,2359843,0.99
1453,103,-10.2,2080,2361923,0.99
1454,97,-9.6,2060,2363983,0.99
1455,105,-10.4,2066,2366049,0.99
1456,172,-17.1,2082,2368131,0.99
1457,125,-12.4,2044,2370175,0.99
1458,113,-11.2,2070,2372245,0.99
1459,104,-10.3,2079,2374324,0.99
1460,128,-12.7,2061,2376385,0.99
1461,109,-14.4,2068,2378453,0.99
1462,107,-10.6,2056,2380509,0.99
1463,106,-10.5,2060,2382569,0.99
1464,96,-9.5,2043,2384612,0.99
1465,97,-9.6,2062,2386674,0.99
1466,168,-16.7,2055,2388729,0.99
1467,174,-17.3,2014,2390743,0.99
1468,103,-10.2,2092,2392835,0.99
1469,109,-12.6,2055,2394890,0.99
1470,121,-12,2089,2396979,0.99
1471,94,-9.3,2086,2399065,0.99
1472,120,-11.9,2085,2401150,0.99
1473,89,-8.8,2087,2403237,0.99
1474,133,-13.2,2061,2405298,0.99
1475,97,-9.6,2038,2407336,0.99
1476,152,-16,2068,2409404,0.99
1477,94,-9.3,2038,2411442,0.99
1478,135,-13.4,2082,2413524,0.99
1479,109,-10.8,2130,2415654,0.99
1480,100,-9.9,2023,2417677,0.99
1481,99,-9.8,2071,2419748,0.99
1482,121,-12,2063,2421811,0.99
1483,122,-12.1,2048,2423859,0.99
1484,112,-11.1,2048,2425907,0.99
1485,98,-9.7,2062,2427969,0.99
1486,101,-10,2072,2430041,0.99
1487,91,-9,2046,2432087,0.99
1488,178,-17.7,2024,2434111,0.99
1489,236,-24.4,2048,2436159,0.99
1490,100,-10.8,2066,2438225,0.99
1491,89,-8.8,2055,2440280,0.99
1492,94,-9.3,2102,2442382,0.99
1493,119,-12.7,2081,2444463,0.99
1494,113,-11.2,2104,2446567,0.99
1495,108,-10.7,2060,2448627,0.99
1496,91,-9,2067,2450694,0.99
1497,98,-9.7,2038,2452732,0.99
1498,97,-9.6,2060,2454792,0.99
1499,91,-9,2094,2456886,0.99
1500,135,-14.3,2113,2458999,0.99
