1,64,-27.2,77,77,0.99
2,64,-12,11,88,0.99
3,64,-6.3,51,139,0.99
4,64,-6.3,26,165,0.99
5,64,-6.3,142,307,0.99
6,64,-8.2,59,366,0.99
7,64,-6.3,45,411,0.99
8,64,-6.3,51,462,0.99
9,64,-30,61,523,0.99
10,64,-6.3,20,543,0.99
11,64,-38.6,45,588,0.99
12,64,-6.3,116,704,0.99
13,64,-6.3,84,788,0.99
14,64,-9,80,868,0.99
15,64,-8.2,54,922,0.99
16,64,-6.3,46,968,0.99
17,64,-15.9,87,1055,0.99
18,64,-19.6,118,1173,0.99
19,64,-6.3,115,1288,0.99
20,64,-6.3,28,1316,0.99
21,64,-6.3,51,1367,0.99
22,64,-13.9,82,1449,0.99
23,64,-6.3,74,1523,0.99
24,64,-6.3,92,1615,0.99
25,64,-6.3,174,1789,0.99
26,64,-6.3,67,1856,0.99
27,64,-6.3,83,1939,0.99
28,64,-15.8,40,1979,0.99
29,64,-6.3,56,2035,0.99
30,64,-6.3,45,2080,0.99
31,64,-6.3,33,2113,0.99
32,64,-10.1,29,2142,0.99
33,64,-6.3,43,2185,0.99
34,64,-8.2,34,2219,0.99
35,64,-10.1,39,2258,0.99
36,64,-6.3,41,2299,0.99
37,64,-6.3,56,2355,0.99
38,64,-6.3,55,2410,0.99
39,64,-6.3,51,2461,0.99
40,64,-6.3,57,2518,0.99
41,64,-7.2,33,2551,0.99
42,64,-6.3,40,2591,0.99
43,64,-8.2,36,2627,0.99
44,64,-6.3,34,2661,0.99
45,64,-6.3,35,2696,0.99
46,64,-8.2,33,2729,0.99
47,64,-6.3,32,2761,0.99
48,64,-6.3,41,2802,0.99
49,64,-13.9,33,2835,0.99
50,64,-8.2,33,2868,0.99
51,64,-6.3,39,2907,0.99
52,64,-6.3,43,2950,0.99
53,64,-8.1,40,2990,0.99
54,64,-6.3,38,3028,0.99
55,64,-6.3,40,3068,0.99
56,64,-6.3,49,3117,0.99
57,64,-6.3,64,3181,0.99
58,64,-6.3,65,3246,0.99
59,64,-6.3,72,3318,0.99
60,64,-6.3,66,3384,0.99
61,64,-6.3,80,3464,0.99
62,64,-7.2,68,3532,0.99
63,64,-12,67,3599,0.99
64,64,-8.2,44,3643,0.99
65,64,-8.1,49,3692,0.99
66,64,-12.9,44,3736,0.99
67,64,-6.3,45,3781,0.99
68,64,-8.2,42,3823,0.99
69,64,-6.3,45,3868,0.99
70,64,-6.3,47,3915,0.99
71,64,-6.3,48,3963,0.99
72,63,-6.2,52,4015,0.99
73,64,-6.3,43,4058,0.99
74,64,-6.3,46,4104,0.99
75,64,-6.3,53,4157,0.99
76,64,-6.3,53,4210,0.99
77,64,-6.3,50,4260,0.99
78,64,-27.2,47,4307,0.99
79,64,-6.3,48,4355,0.99
80,64,-6.3,51,4406,0.99
81,64,-10.1,46,4452,0.99
82,64,-6.3,54,4506,0.99
83,64,-6.3,59,4565,0.99
84,64,-6.3,58,4623,0.99
85,64,-6.3,55,4678,0.99
86,64,-6.3,53,4731,0.99
87,64,-6.3,53,4784,0.99
88,64,-6.3,53,4837,0.99
89,64,-8.2,49,4886,0.99
90,64,-11,58,4944,0.99
91,64,-6.3,49,4993,0.99
92,64,-6.3,51,5044,0.99
93,64,-12,53,5097,0.99
94,64,-6.3,50,5147,0.99
95,64,-8.2,57,5204,0.99
96,64,-11,55,5259,0.99
97,64,-6.3,51,5310,0.99
98,64,-10.1,53,5363,0.99
99,23,-8,61,5424,0.99
100,64,-7.2,51,5475,0.99
101,51,-6.9,56,5531,0.99
102,64,-13.9,64,5595,0.99
103,64,-6.3,57,5652,0.99
104,64,-6.3,58,5710,0.99
105,64,-6.3,55,5765,0.99
106,64,-8.2,59,5824,0.99
107,64,-13,62,5886,0.99
108,64,-8.2,61,5947,0.99
109,58,-6.6,58,6005,0.99
110,64,-6.3,56,6061,0.99
111,64,-6.3,54,6115,0.99
112,64,-7.2,53,6168,0.99
113,36,-4.4,60,6228,0.99
114,64,-21.7,59,6287,0.99
115,64,-6.3,61,6348,0.99
116,49,-4.8,58,6406,0.99
117,64,-6.3,56,6462,0.99
118,64,-6.3,64,6526,0.99
119,64,-39.6,74,6600,0.99
120,64,-6.3,62,6662,0.99
121,64,-6.3,61,6723,0.99
122,64,-6.3,61,6784,0.99
123,64,-6.3,56,6840,0.99
124,64,-6.3,59,6899,0.99
125,51,-7.9,68,6967,0.99
126,64,-6.3,64,7031,0.99
127,64,-6.3,62,7093,0.99
128,42,-4.1,71,7164,0.99
129,64,-6.3,65,7229,0.99
130,64,-10,62,7291,0.99
131,64,-6.3,63,7354,0.99
132,64,-6.3,71,7425,0.99
133,64,-6.3,71,7496,0.99
134,64,-6.3,66,7562,0.99
135,64,-8.2,64,7626,0.99
136,35,-3.4,61,7687,0.99
137,62,-7,62,7749,0.99
138,64,-9.1,68,7817,0.99
139,64,-7.2,67,7884,0.99
140,33,-3.2,68,7952,0.99
141,64,-6.3,68,8020,0.99
142,64,-6.3,65,8085,0.99
143,64,-6.3,63,8148,0.99
144,49,-13.3,72,8220,0.99
145,32,-3.1,68,8288,0.99
146,64,-6.3,70,8358,0.99
147,64,-8.1,66,8424,0.99
148,64,-6.3,74,8498,0.99
149,64,-7.2,77,8575,0.99
150,64,-6.3,68,8643,0.99
151,64,-8.2,66,8709,0.99
152,64,-13.9,72,8781,0.99
153,64,-6.3,71,8852,0.99
154,64,-6.3,72,8924,0.99
155,57,-5.6,70,8994,0.99
156,64,-8.2,67,9061,0.99
157,64,-7.2,77,9138,0.99
158,64,-6.3,79,9217,0.99
159,64,-6.3,67,9284,0.99
160,40,-3.9,78,9362,0.99
161,64,-6.3,72,9434,0.99
162,64,-6.3,66,9500,0.99
163,17,-2.5,79,9579,0.99
164,64,-6.3,71,9650,0.99
165,33,-3.2,76,9726,0.99
166,64,-6.3,71,9797,0.99
167,63,-6.2,69,9866,0.99
168,64,-12.1,71,9937,0.99
169,64,-10.8,73,10010,0.99
170,31,-3,71,10081,0.99
171,64,-6.3,84,10165,0.99
172,64,-6.3,70,10235,0.99
173,32,-4.9,69,10304,0.99
174,27,-5.4,68,10372,0.99
175,39,-4.7,72,10444,0.99
176,64,-6.3,100,10544,0.99
177,64,-6.3,88,10632,0.99
178,64,-6.3,67,10699,0.99
179,64,-26.6,69,10768,0.99
180,34,-5.1,69,10837,0.99
181,21,-2,77,10914,0.99
182,64,-14.4,67,10981,0.99
183,31,-4.9,70,11051,0.99
184,64,-6.3,75,11126,0.99
185,21,-2,71,11197,0.99
186,29,-2.8,71,11268,0.99
187,64,-6.3,77,11345,0.99
188,64,-6.3,76,11421,0.99
189,64,-8.2,82,11503,0.99
190,30,-2.9,74,11577,0.99
191,64,-6.3,72,11649,0.99
192,64,-6.3,74,11723,0.99
193,45,-6.3,72,11795,0.99
194,39,-3.8,73,11868,0.99
195,64,-6.3,80,11948,0.99
196,64,-12.9,69,12017,0.99
197,52,-7,78,12095,0.99
198,24,-3.2,77,12172,0.99
199,17,-1.6,76,12248,0.99
200,41,-21.1,77,12325,0.99
201,19,-1.8,76,12401,0.99
202,42,-4.1,74,12475,0.99
203,64,-6.3,81,12556,0.99
204,45,-5.3,74,12630,0.99
205,64,-10,82,12712,0.99
206,64,-6.3,91,12803,0.99
207,64,-6.3,77,12880,0.99
208,64,-18.8,82,12962,0.99
209,19,-3.7,74,13036,0.99
210,19,-1.8,82,13118,0.99
211,15,-3.3,73,13191,0.99
212,30,-4.8,74,13265,0.99
213,49,-6.7,77,13342,0.99
214,64,-6.3,71,13413,0.99
215,64,-6.3,84,13497,0.99
216,64,-6.3,75,13572,0.99
217,39,-7.5,73,13645,0.99
218,30,-4.8,76,13721,0.99
219,64,-9,76,13797,0.99
220,32,-4,82,13879,0.99
221,64,-6.3,77,13956,0.99
222,44,-5.2,75,14031,0.99
223,61,-6,75,14106,0.99
224,64,-6.3,80,14186,0.99
225,35,-3.4,74,14260,0.99
226,64,-6.3,80,14340,0.99
227,64,-6.3,77,14417,0.99
228,64,-8.2,88,14505,0.99
229,54,-8.1,79,14584,0.99
230,22,-2.1,79,14663,0.99
231,34,-3.3,78,14741,0.99
232,64,-6.3,77,14818,0.99
233,64,-6.3,80,14898,0.99
234,64,-6.3,104,15002,0.99
235,64,-25.3,109,15111,0.99
236,64,-7.2,76,15187,0.99
237,64,-6.3,83,15270,0.99
238,19,-1.8,80,15350,0.99
239,64,-6.3,80,15430,0.99
240,20,-1.9,86,15516,0.99
241,64,-7.2,78,15594,0.99
242,64,-6.3,78,15672,0.99
243,64,-17.7,78,15750,0.99
244,64,-6.3,75,15825,0.99
245,46,-6.4,76,15901,0.99
246,64,-6.3,82,15983,0.99
247,37,-5.5,80,16063,0.99
248,29,-3.7,81,16144,0.99
249,64,-7.2,78,16222,0.99
250,64,-7.2,83,16305,0.99
251,25,-3.3,76,16381,0.99
252,64,-6.3,78,16459,0.99
253,23,-3.1,94,16553,0.99
254,53,-7,81,16634,0.99
255,64,-6.3,82,16716,0.99
256,25,-2.4,80,16796,0.99
257,20,-1.9,82,16878,0.99
258,48,-5.6,71,16949,0.99
259,19,-2.7,84,17033,0.99
260,23,-4,78,17111,0.99
261,37,-5.4,86,17197,0.99
262,64,-6.3,80,17277,0.99
263,25,-2.4,86,17363,0.99
264,64,-12.6,79,17442,0.99
265,24,-4.2,95,17537,0.99
266,29,-2.8,81,17618,0.99
267,24,-3.2,88,17706,0.99
268,64,-6.3,81,17787,0.99
269,64,-9,89,17876,0.99
270,64,-7.2,83,17959,0.99
271,64,-6.3,88,18047,0.99
272,23,-2.2,90,18137,0.99
273,49,-7.5,87,18224,0.99
274,35,-3.4,79,18303,0.99
275,30,-2.9,85,18388,0.99
276,25,-7.1,88,18476,0.99
277,50,-4.9,84,18560,0.99
278,18,-1.7,84,18644,0.99
279,64,-7.2,85,18729,0.99
280,40,-4.8,87,18816,0.99
281,22,-3,84,18900,0.99
282,36,-7.1,86,18986,0.99
283,64,-7.2,85,19071,0.99
284,46,-7.3,82,19153,0.99
285,64,-9.2,84,19237,0.99
286,54,-5.3,88,19325,0.99
287,64,-6.3,86,19411,0.99
288,64,-7.2,99,19510,0.99
289,20,-1.9,85,19595,0.99
290,22,-2.1,82,19677,0.99
291,56,-5.5,87,19764,0.99
292,23,-4,86,19850,0.99
293,18,-1.7,96,19946,0.99
294,29,-2.8,118,20064,0.99
295,18,-1.7,90,20154,0.99
296,25,-4.2,86,20240,0.99
297,23,-3.1,84,20324,0.99
298,55,-5.4,78,20402,0.99
299,30,-2.9,89,20491,0.99
300,64,-6.3,86,20577,0.99
301,24,-3.2,85,20662,0.99
302,26,-2.5,88,20750,0.99
303,26,-2.5,85,20835,0.99
304,22,-3.9,86,20921,0.99
305,32,-6.9,88,21009,0.99
306,64,-6.3,86,21095,0.99
307,64,-6.3,83,21178,0.99
308,64,-9.1,91,21269,0.99
309,32,-3.1,86,21355,0.99
310,24,-2.3,164,21519,0.99
311,40,-3.9,107,21626,0.99
312,32,-3.1,156,21782,0.99
313,64,-10.1,131,21913,0.99
314,25,-2.4,94,22007,0.99
315,18,-1.7,93,22100,0.99
316,32,-5.8,107,22207,0.99
317,21,-2,95,22302,0.99
318,20,-2.8,90,22392,0.99
319,18,-2.6,99,22491,0.99
320,26,-4.3,83,22574,0.99
321,28,-2.7,92,22666,0.99
322,39,-3.8,91,22757,0.99
323,64,-6.3,109,22866,0.99
324,16,-1.5,97,22963,0.99
325,28,-4.5,98,23061,0.99
326,23,-2.2,138,23199,0.99
327,64,-6.3,116,23315,0.99
328,18,-4.5,193,23508,0.99
329,17,-1.6,110,23618,0.99
330,18,-3.5,91,23709,0.99
331,29,-3.7,151,23860,0.99
332,30,-2.9,191,24051,0.99
333,44,-4.3,121,24172,0.99
334,26,-2.5,115,24287,0.99
335,54,-7.1,93,24380,0.99
336,35,-3.4,116,24496,0.99
337,21,-2,99,24595,0.99
338,18,-1.7,111,24706,0.99
339,30,-9.3,116,24822,0.99
340,21,-2,131,24953,0.99
341,23,-3.1,149,25102,0.99
342,22,-6.8,123,25225,0.99
343,31,-3.9,159,25384,0.99
344,21,-2,229,25613,0.99
345,55,-6.3,106,25719,0.99
346,26,-6.3,97,25816,0.99
347,26,-2.5,106,25922,0.99
348,21,-2,91,26013,0.99
349,64,-6.3,109,26122,0.99
350,23,-2.2,98,26220,0.99
351,64,-6.3,93,26313,0.99
352,24,-2.3,88,26401,0.99
353,64,-6.3,109,26510,0.99
354,21,-2,132,26642,0.99
355,22,-5.9,113,26755,0.99
356,19,-2.7,91,26846,0.99
357,31,-3.9,94,26940,0.99
358,22,-2.1,91,27031,0.99
359,64,-6.3,96,27127,0.99
360,24,-4.2,90,27217,0.99
361,29,-2.8,91,27308,0.99
362,19,-1.8,97,27405,0.99
363,22,-2.1,98,27503,0.99
364,34,-3.3,107,27610,0.99
365,27,-6.4,103,27713,0.99
366,20,-1.9,110,27823,0.99
367,23,-4.1,93,27916,0.99
368,25,-2.4,102,28018,0.99
369,19,-1.8,113,28131,0.99
370,48,-6.6,99,28230,0.99
371,25,-3.3,96,28326,0.99
372,22,-2.1,187,28513,0.99
373,23,-3.1,129,28642,0.99
374,21,-2,106,28748,0.99
375,25,-9,122,28870,0.99
376,64,-7.2,125,28995,0.99
377,20,-2.8,138,29133,0.99
378,34,-3.3,113,29246,0.99
379,36,-3.5,104,29350,0.99
380,19,-1.8,121,29471,0.99
381,62,-7,145,29616,0.99
382,56,-5.5,133,29749,0.99
383,21,-2,117,29866,0.99
384,21,-2,115,29981,0.99
385,64,-6.3,143,30124,0.99
386,24,-4.2,107,30231,0.99
387,18,-2.6,123,30354,0.99
388,64,-6.3,133,30487,0.99
389,26,-3.4,98,30585,0.99
390,18,-1.7,106,30691,0.99
391,26,-6.3,109,30800,0.99
392,51,-5,95,30895,0.99
393,22,-2.1,124,31019,0.99
394,18,-2.6,96,31115,0.99
395,20,-1.9,98,31213,0.99
396,49,-4.8,98,31311,0.99
397,35,-8.1,122,31433,0.99
398,23,-2.2,116,31549,0.99
399,19,-1.8,193,31742,0.99
400,26,-4.3,195,31937,0.99
401,27,-2.6,162,32099,0.99
402,23,-4.1,134,32233,0.99
403,19,-1.8,132,32365,0.99
404,21,-2.9,147,32512,0.99
405,27,-3.5,172,32684,0.99
406,19,-1.8,197,32881,0.99
407,22,-2.1,150,33031,0.99
408,22,-3.9,139,33170,0.99
409,35,-6.2,298,33468,0.99
410,21,-2,138,33606,0.99
411,26,-2.5,98,33704,0.99
412,23,-3.1,105,33809,0.99
413,25,-2.4,99,33908,0.99
414,43,-4.2,100,34008,0.99
415,35,-5.3,99,34107,0.99
416,15,-1.4,144,34251,0.99
417,34,-3.3,195,34446,0.99
418,20,-1.9,112,34558,0.99
419,30,-2.9,99,34657,0.99
420,20,-5.6,102,34759,0.99
421,55,-5.4,113,34872,0.99
422,18,-2.6,101,34973,0.99
423,38,-3.7,126,35099,0.99
424,19,-1.8,99,35198,0.99
425,19,-1.8,120,35318,0.99
426,23,-4,112,35430,0.99
427,24,-2.3,101,35531,0.99
428,21,-3.9,98,35629,0.99
429,27,-2.6,120,35749,0.99
430,19,-2.7,111,35860,0.99
431,64,-6.3,126,35986,0.99
432,25,-2.4,103,36089,0.99
433,64,-6.3,100,36189,0.99
434,23,-3.1,109,36298,0.99
435,28,-2.7,104,36402,0.99
436,26,-2.5,108,36510,0.99
437,25,-3.3,112,36622,0.99
438,27,-4.4,97,36719,0.99
439,64,-6.3,104,36823,0.99
440,30,-2.9,100,36923,0.99
441,22,-3,103,37026,0.99
442,21,-2.9,100,37126,0.99
443,29,-3.7,105,37231,0.99
444,64,-6.3,96,37327,0.99
445,48,-12.3,109,37436,0.99
446,64,-7.2,99,37535,0.99
447,26,-6.3,101,37636,0.99
448,25,-3.3,107,37743,0.99
449,29,-2.8,105,37848,0.99
450,15,-3.3,130,37978,0.99
451,29,-2.8,105,38083,0.99
452,26,-6.3,101,38184,0.99
453,23,-2.2,104,38288,0.99
454,34,-7.1,111,38399,0.99
455,64,-9.9,100,38499,0.99
456,23,-2.2,102,38601,0.99
457,28,-6.5,100,38701,0.99
458,19,-2.7,190,38891,0.99
459,20,-1.9,213,39104,0.99
460,29,-6.6,220,39324,0.99
461,22,-3.9,175,39499,0.99
462,26,-2.5,167,39666,0.99
463,64,-6.3,187,39853,0.99
464,20,-2.8,136,39989,0.99
465,22,-4,153,40142,0.99
466,15,-1.4,142,40284,0.99
467,20,-2.8,188,40472,0.99
468,18,-1.7,197,40669,0.99
469,22,-2.1,135,40804,0.99
470,18,-1.7,123,40927,0.99
471,36,-28.5,140,41067,0.99
472,27,-2.6,99,41166,0.99
473,24,-2.3,110,41276,0.99
474,24,-2.3,166,41442,0.99
475,42,-6.9,102,41544,0.99
476,20,-1.9,122,41666,0.99
477,20,-1.9,108,41774,0.99
478,64,-14.8,106,41880,0.99
479,18,-2.6,104,41984,0.99
480,23,-2.2,99,42083,0.99
481,64,-6.3,101,42184,0.99
482,26,-3.4,115,42299,0.99
483,24,-2.3,111,42410,0.99
484,21,-3.9,114,42524,0.99
485,21,-2,110,42634,0.99
486,64,-8.2,104,42738,0.99
487,20,-1.9,139,42877,0.99
488,19,-1.8,110,42987,0.99
489,21,-2,107,43094,0.99
490,43,-6.1,107,43201,0.99
491,24,-2.3,101,43302,0.99
492,50,-4.9,126,43428,0.99
493,45,-5.3,117,43545,0.99
494,22,-2.1,109,43654,0.99
495,27,-2.6,112,43766,0.99
496,58,-9.5,145,43911,0.99
497,28,-2.7,153,44064,0.99
498,17,-2.5,126,44190,0.99
499,31,-3.9,164,44354,0.99
500,21,-2,118,44472,0.99
501,19,-1.8,125,44597,0.99
502,26,-6.3,97,44694,0.99
503,64,-6.3,107,44801,0.99
504,21,-2,111,44912,0.99
505,64,-6.3,113,45025,0.99
506,20,-1.9,116,45141,0.99
507,19,-1.8,107,45248,0.99
508,30,-4.7,117,45365,0.99
509,22,-4.9,102,45467,0.99
510,23,-2.2,104,45571,0.99
511,20,-1.9,107,45678,0.99
512,57,-5.6,131,45809,0.99
513,19,-1.8,106,45915,0.99
514,20,-1.9,121,46036,0.99
515,30,-6.7,117,46153,0.99
516,20,-1.9,114,46267,0.99
517,17,-5.4,176,46443,0.99
518,19,-5.6,220,46663,0.99
519,20,-1.9,115,46778,0.99
520,28,-4.6,124,46902,0.99
521,64,-7.2,136,47038,0.99
522,17,-1.6,124,47162,0.99
523,26,-3.4,135,47297,0.99
524,24,-2.3,118,47415,0.99
525,18,-1.7,123,47538,0.99
526,19,-3.7,112,47650,0.99
527,36,-5.4,109,47759,0.99
528,30,-2.9,104,47863,0.99
529,28,-3.6,111,47974,0.99
530,29,-2.8,108,48082,0.99
531,64,-6.3,112,48194,0.99
532,55,-8.2,103,48297,0.99
533,20,-2.8,112,48409,0.99
534,27,-2.6,110,48519,0.99
535,25,-2.4,171,48690,0.99
536,17,-1.6,152,48842,0.99
537,58,-8.5,135,48977,0.99
538,27,-2.6,216,49193,0.99
539,21,-2,111,49304,0.99
540,19,-1.8,121,49425,0.99
541,19,-1.8,105,49530,0.99
542,18,-1.7,109,49639,0.99
543,24,-2.3,111,49750,0.99
544,55,-5.4,108,49858,0.99
545,20,-2.8,110,49968,0.99
546,20,-5.7,141,50109,0.99
547,43,-4.2,114,50223,0.99
548,23,-2.2,153,50376,0.99
549,17,-1.6,106,50482,0.99
550,26,-2.5,127,50609,0.99
551,21,-2.9,109,50718,0.99
552,24,-2.3,109,50827,0.99
553,27,-2.6,110,50937,0.99
554,26,-2.5,113,51050,0.99
555,25,-3.3,113,51163,0.99
556,23,-2.2,102,51265,0.99
557,18,-3.6,120,51385,0.99
558,21,-2.9,140,51525,0.99
559,35,-8.1,116,51641,0.99
560,28,-3.6,135,51776,0.99
561,28,-3.6,121,51897,0.99
562,21,-2,108,52005,0.99
563,26,-2.5,116,52121,0.99
564,27,-3.5,128,52249,0.99
565,64,-6.3,122,52371,0.99
566,29,-4.6,113,52484,0.99
567,29,-2.8,127,52611,0.99
568,22,-4,113,52724,0.99
569,26,-2.5,108,52832,0.99
570,22,-3,121,52953,0.99
571,23,-6,116,53069,0.99
572,27,-3.5,118,53187,0.99
573,41,-4,150,53337,0.99
574,22,-2.1,116,53453,0.99
575,32,-3.1,130,53583,0.99
576,20,-1.9,147,53730,0.99
577,29,-3.7,160,53890,0.99
578,19,-3.7,146,54036,0.99
579,23,-3.1,126,54162,0.99
580,24,-2.3,110,54272,0.99
581,24,-4.2,128,54400,0.99
582,25,-5.1,113,54513,0.99
583,26,-2.5,115,54628,0.99
584,26,-2.5,112,54740,0.99
585,21,-2,110,54850,0.99
586,25,-3.3,125,54975,0.99
587,41,-5.8,125,55100,0.99
588,19,-1.8,119,55219,0.99
589,21,-2,124,55343,0.99
590,18,-2.6,111,55454,0.99
591,22,-3,112,55566,0.99
592,20,-1.9,111,55677,0.99
593,20,-1.9,110,55787,0.99
594,18,-1.7,158,55945,0.99
595,23,-3.1,109,56054,0.99
596,23,-2.2,117,56171,0.99
597,43,-10.9,113,56284,0.99
598,23,-2.2,123,56407,0.99
599,38,-4.6,108,56515,0.99
600,26,-4.4,112,56627,0.99
601,22,-2.1,130,56757,0.99
602,19,-1.8,116,56873,0.99
603,25,-4.2,124,56997,0.99
604,19,-1.8,113,57110,0.99
605,22,-3,117,57227,0.99
606,64,-6.3,121,57348,0.99
607,15,-3.3,119,57467,0.99
608,23,-4,186,57653,0.99
609,46,-5.4,118,57771,0.99
610,22,-3,115,57886,0.99
611,20,-1.9,150,58036,0.99
612,20,-1.9,137,58173,0.99
613,22,-2.1,215,58388,0.99
614,27,-4.4,135,58523,0.99
615,21,-3.9,144,58667,0.99
616,24,-2.3,123,58790,0.99
617,25,-3.3,230,59020,0.99
618,16,-1.5,128,59148,0.99
619,28,-6.5,129,59277,0.99
620,29,-4.7,128,59405,0.99
621,18,-2.6,123,59528,0.99
622,17,-1.6,110,59638,0.99
623,24,-2.3,122,59760,0.99
624,20,-1.9,110,59870,0.99
625,21,-2,130,60000,0.99
626,20,-3.8,122,60122,0.99
627,23,-2.2,113,60235,0.99
628,22,-4,128,60363,0.99
629,64,-8.2,118,60481,0.99
630,20,-2.8,136,60617,0.99
631,64,-10.1,139,60756,0.99
632,20,-1.9,112,60868,0.99
633,21,-2.9,133,61001,0.99
634,21,-2,122,61123,0.99
635,20,-3.8,116,61239,0.99
636,28,-3.6,126,61365,0.99
637,19,-1.8,118,61483,0.99
638,17,-1.6,123,61606,0.99
639,23,-2.2,119,61725,0.99
640,31,-4.8,118,61843,0.99
641,24,-3.2,146,61989,0.99
642,64,-7.2,116,62105,0.99
643,28,-5.6,120,62225,0.99
644,23,-2.2,126,62351,0.99
645,27,-4.5,115,62466,0.99
646,47,-4.6,116,62582,0.99
647,19,-1.8,127,62709,0.99
648,28,-5.5,115,62824,0.99
649,35,-5.2,119,62943,0.99
650,15,-3.3,111,63054,0.99
651,20,-5.7,116,63170,0.99
652,21,-2,122,63292,0.99
653,29,-2.8,114,63406,0.99
654,26,-2.5,117,63523,0.99
655,23,-2.2,116,63639,0.99
656,17,-1.6,127,63766,0.99
657,21,-4.8,118,63884,0.99
658,29,-2.8,120,64004,0.99
659,21,-3.8,125,64129,0.99
660,27,-2.6,112,64241,0.99
661,24,-3.2,126,64367,0.99
662,20,-1.9,127,64494,0.99
663,32,-4.9,127,64621,0.99
664,64,-13.8,117,64738,0.99
665,32,-7.6,127,64865,0.99
666,19,-2.7,119,64984,0.99
667,19,-2.7,137,65121,0.99
668,31,-3,124,65245,0.99
669,24,-4.2,130,65375,0.99
670,30,-6.7,120,65495,0.99
671,15,-2.3,117,65612,0.99
672,24,-3.2,125,65737,0.99
673,18,-4.5,156,65893,0.99
674,18,-1.7,140,66033,0.99
675,19,-2.7,123,66156,0.99
676,29,-2.8,141,66297,0.99
677,21,-2.9,123,66420,0.99
678,24,-5.1,131,66551,0.99
679,17,-1.6,124,66675,0.99
680,24,-2.3,125,66800,0.99
681,27,-2.6,140,66940,0.99
682,33,-6.1,126,67066,0.99
683,63,-7.1,115,67181,0.99
684,16,-1.5,125,67306,0.99
685,20,-1.9,120,67426,0.99
686,22,-3,121,67547,0.99
687,18,-1.7,117,67664,0.99
688,25,-5.2,122,67786,0.99
689,19,-2.7,124,67910,0.99
690,17,-1.6,143,68053,0.99
691,21,-2.9,187,68240,0.99
692,29,-2.8,135,68375,0.99
693,16,-1.5,123,68498,0.99
694,21,-2,123,68621,0.99
695,20,-1.9,126,68747,0.99
696,22,-2.1,118,68865,0.99
697,31,-3.9,125,68990,0.99
698,22,-2.1,123,69113,0.99
699,23,-2.2,119,69232,0.99
700,20,-2.8,126,69358,0.99
701,32,-3.1,134,69492,0.99
702,23,-3.1,122,69614,0.99
703,18,-3.6,120,69734,0.99
704,21,-2.9,123,69857,0.99
705,19,-2.7,198,70055,0.99
706,27,-2.6,133,70188,0.99
707,29,-3.7,126,70314,0.99
708,21,-2,115,70429,0.99
709,27,-3.5,127,70556,0.99
710,28,-2.7,136,70692,0.99
711,18,-1.7,125,70817,0.99
712,23,-3.1,130,70947,0.99
713,25,-2.4,123,71070,0.99
714,23,-7.9,148,71218,0.99
715,25,-2.4,159,71377,0.99
716,60,-5.9,121,71498,0.99
717,15,-3.3,123,71621,0.99
718,18,-1.7,118,71739,0.99
719,22,-3,125,71864,0.99
720,31,-8.7,125,71989,0.99
721,20,-2.8,133,72122,0.99
722,19,-1.8,161,72283,0.99
723,64,-6.3,133,72416,0.99
724,64,-6.3,128,72544,0.99
725,25,-2.4,147,72691,0.99
726,21,-2,120,72811,0.99
727,15,-1.4,131,72942,0.99
728,64,-6.3,186,73128,0.99
729,53,-5.2,148,73276,0.99
730,42,-5,132,73408,0.99
731,19,-2.7,144,73552,0.99
732,49,-6.7,123,73675,0.99
733,25,-2.4,116,73791,0.99
734,17,-2.5,120,73911,0.99
735,27,-2.6,163,74074,0.99
736,35,-4.3,118,74192,0.99
737,38,-3.7,126,74318,0.99
738,21,-3.8,122,74440,0.99
739,23,-2.2,133,74573,0.99
740,26,-2.5,124,74697,0.99
741,19,-3.7,125,74822,0.99
742,64,-13.5,126,74948,0.99
743,27,-2.6,133,75081,0.99
744,26,-5.3,126,75207,0.99
745,26,-2.5,142,75349,0.99
746,17,-1.6,120,75469,0.99
747,22,-3,124,75593,0.99
748,42,-4.1,123,75716,0.99
749,23,-2.2,120,75836,0.99
750,33,-5.9,120,75956,0.99
751,18,-3.6,120,76076,0.99
752,27,-2.6,132,76208,0.99
753,24,-2.3,140,76348,0.99
754,24,-4.2,121,76469,0.99
755,17,-2.5,124,76593,0.99
756,25,-2.4,125,76718,0.99
757,16,-3.4,128,76846,0.99
758,23,-3.1,127,76973,0.99
759,22,-2.1,122,77095,0.99
760,19,-4.6,121,77216,0.99
761,19,-1.8,133,77349,0.99
762,25,-3.3,125,77474,0.99
763,24,-2.3,135,77609,0.99
764,22,-3,128,77737,0.99
765,64,-6.3,126,77863,0.99
766,54,-9.1,125,77988,0.99
767,64,-6.3,126,78114,0.99
768,20,-2.8,133,78247,0.99
769,19,-3.6,125,78372,0.99
770,18,-2.6,127,78499,0.99
771,21,-2,120,78619,0.99
772,21,-2,122,78741,0.99
773,21,-2,128,78869,0.99
774,23,-5,124,78993,0.99
775,22,-2.1,152,79145,0.99
776,20,-1.9,199,79344,0.99
777,30,-2.9,168,79512,0.99
778,22,-2.1,129,79641,0.99
779,27,-2.6,130,79771,0.99
780,20,-1.9,138,79909,0.99
781,24,-5.1,131,80040,0.99
782,21,-2,165,80205,0.99
783,17,-5.4,151,80356,0.99
784,21,-2,164,80520,0.99
785,20,-1.9,182,80702,0.99
786,39,-3.8,162,80864,0.99
787,25,-2.4,140,81004,0.99
788,34,-5.1,132,81136,0.99
789,20,-1.9,134,81270,0.99
790,23,-2.2,132,81402,0.99
791,25,-3.3,165,81567,0.99
792,25,-5.2,168,81735,0.99
793,31,-5.8,139,81874,0.99
794,24,-3.2,156,82030,0.99
795,26,-2.5,143,82173,0.99
796,26,-2.5,157,82330,0.99
797,19,-1.8,127,82457,0.99
798,19,-1.8,135,82592,0.99
799,18,-2.6,165,82757,0.99
800,27,-2.6,159,82916,0.99
801,43,-4.2,140,83056,0.99
802,26,-3.4,148,83204,0.99
803,44,-6.2,145,83349,0.99
804,21,-2,148,83497,0.99
805,22,-3,144,83641,0.99
806,20,-1.9,146,83787,0.99
807,25,-2.4,134,83921,0.99
808,21,-2.9,139,84060,0.99
809,15,-2.3,163,84223,0.99
810,19,-3.7,161,84384,0.99
811,22,-2.1,125,84509,0.99
812,33,-4.1,142,84651,0.99
813,23,-2.2,127,84778,0.99
814,21,-3.8,157,84935,0.99
815,25,-2.4,142,85077,0.99
816,17,-1.6,179,85256,0.99
817,18,-1.7,151,85407,0.99
818,17,-1.6,133,85540,0.99
819,20,-2.8,123,85663,0.99
820,29,-2.8,128,85791,0.99
821,26,-2.5,158,85949,0.99
822,26,-6.2,161,86110,0.99
823,31,-3.9,138,86248,0.99
824,19,-1.8,152,86400,0.99
825,24,-2.3,135,86535,0.99
826,26,-2.5,126,86661,0.99
827,29,-5.5,133,86794,0.99
828,20,-1.9,128,86922,0.99
829,22,-3,133,87055,0.99
830,32,-5,182,87237,0.99
831,48,-7.5,145,87382,0.99
832,27,-2.6,140,87522,0.99
833,64,-6.3,129,87651,0.99
834,20,-3.8,152,87803,0.99
835,18,-1.7,137,87940,0.99
836,23,-4.1,143,88083,0.99
837,60,-12.5,160,88243,0.99
838,23,-3.1,143,88386,0.99
839,22,-2.1,196,88582,0.99
840,19,-3.7,152,88734,0.99
841,24,-2.3,131,88865,0.99
842,64,-6.3,169,89034,0.99
843,20,-1.9,187,89221,0.99
844,27,-2.6,154,89375,0.99
845,19,-1.8,126,89501,0.99
846,35,-10,153,89654,0.99
847,23,-2.2,145,89799,0.99
848,19,-1.8,143,89942,0.99
849,17,-2.5,125,90067,0.99
850,18,-1.7,149,90216,0.99
851,30,-3.8,131,90347,0.99
852,18,-3.6,156,90503,0.99
853,16,-1.5,149,90652,0.99
854,20,-1.9,126,90778,0.99
855,24,-3.2,127,90905,0.99
856,64,-6.3,134,91039,0.99
857,38,-6.5,138,91177,0.99
858,24,-2.3,149,91326,0.99
859,24,-2.3,131,91457,0.99
860,62,-6.1,134,91591,0.99
861,29,-3.7,137,91728,0.99
862,24,-3.2,136,91864,0.99
863,17,-1.6,130,91994,0.99
864,26,-2.5,136,92130,0.99
865,21,-4.8,146,92276,0.99
866,64,-6.3,137,92413,0.99
867,20,-2.8,142,92555,0.99
868,23,-2.2,129,92684,0.99
869,20,-2.8,152,92836,0.99
870,56,-5.5,135,92971,0.99
871,25,-7.1,131,93102,0.99
872,46,-4.5,128,93230,0.99
873,24,-4.2,131,93361,0.99
874,24,-3.2,128,93489,0.99
875,21,-2.9,131,93620,0.99
876,31,-3,139,93759,0.99
877,24,-3.2,146,93905,0.99
878,25,-3.3,133,94038,0.99
879,21,-3.9,134,94172,0.99
880,33,-3.2,133,94305,0.99
881,21,-2,136,94441,0.99
882,27,-2.6,136,94577,0.99
883,18,-1.7,139,94716,0.99
884,20,-1.9,131,94847,0.99
885,24,-5,137,94984,0.99
886,26,-5.2,134,95118,0.99
887,36,-3.5,167,95285,0.99
888,26,-2.5,128,95413,0.99
889,17,-1.6,139,95552,0.99
890,18,-8.3,130,95682,0.99
891,22,-5.9,133,95815,0.99
892,19,-3.7,149,95964,0.99
893,19,-2.7,137,96101,0.99
894,22,-2.1,141,96242,0.99
895,20,-2.8,137,96379,0.99
896,23,-2.2,133,96512,0.99
897,20,-1.9,134,96646,0.99
898,23,-2.2,137,96783,0.99
899,23,-3.1,140,96923,0.99
900,23,-2.2,132,97055,0.99
901,21,-2,142,97197,0.99
902,19,-3.6,153,97350,0.99
903,22,-2.1,146,97496,0.99
904,16,-2.4,136,97632,0.99
905,20,-1.9,137,97769,0.99
906,19,-1.8,146,97915,0.99
907,24,-2.3,131,98046,0.99
908,30,-3.8,145,98191,0.99
909,20,-1.9,133,98324,0.99
910,24,-2.3,138,98462,0.99
911,15,-2.3,145,98607,0.99
912,19,-1.8,131,98738,0.99
913,53,-5.2,138,98876,0.99
914,25,-4.3,137,99013,0.99
915,23,-2.2,131,99144,0.99
916,26,-2.5,151,99295,0.99
917,21,-2.9,138,99433,0.99
918,21,-3.9,135,99568,0.99
919,20,-1.9,132,99700,0.99
920,39,-5.6,134,99834,0.99
921,23,-2.2,140,99974,0.99
922,25,-2.4,131,100105,0.99
923,22,-2.1,132,100237,0.99
924,23,-3.1,137,100374,0.99
925,30,-2.9,137,100511,0.99
926,22,-2.1,135,100646,0.99
927,24,-3.2,133,100779,0.99
928,48,-10.4,133,100912,0.99
929,26,-2.5,133,101045,0.99
930,23,-2.2,142,101187,0.99
931,22,-2.1,137,101324,0.99
932,20,-3.7,149,101473,0.99
933,19,-2.7,135,101608,0.99
934,22,-2.1,146,101754,0.99
935,20,-1.9,152,101906,0.99
936,39,-13.4,138,102044,0.99
937,21,-3.8,151,102195,0.99
938,61,-14.5,141,102336,0.99
939,22,-2.1,148,102484,0.99
940,19,-1.8,133,102617,0.99
941,19,-1.8,157,102774,0.99
942,25,-4.3,170,102944,0.99
943,24,-4.2,143,103087,0.99
944,38,-4.6,173,103260,0.99
945,18,-1.7,142,103402,0.99
946,24,-3.2,147,103549,0.99
947,19,-1.8,144,103693,0.99
948,20,-1.9,137,103830,0.99
949,25,-2.4,140,103970,0.99
950,20,-4.8,138,104108,0.99
951,18,-1.7,144,104252,0.99
952,27,-3.5,139,104391,0.99
953,26,-3.4,138,104529,0.99
954,19,-1.8,146,104675,0.99
955,19,-1.8,143,104818,0.99
956,23,-3.1,155,104973,0.99
957,19,-1.8,204,105177,0.99
958,30,-2.9,173,105350,0.99
959,33,-3.2,168,105518,0.99
960,37,-4.5,156,105674,0.99
961,24,-3.2,151,105825,0.99
962,24,-2.3,157,105982,0.99
963,23,-3.1,152,106134,0.99
964,20,-2.8,151,106285,0.99
965,22,-2.1,151,106436,0.99
966,18,-1.7,152,106588,0.99
967,17,-1.6,165,106753,0.99
968,26,-4.4,147,106900,0.99
969,28,-7.4,133,107033,0.99
970,28,-2.7,145,107178,0.99
971,21,-2.9,144,107322,0.99
972,22,-2.1,140,107462,0.99
973,19,-1.8,145,107607,0.99
974,19,-2.7,160,107767,0.99
975,25,-2.4,147,107914,0.99
976,34,-7.1,139,108053,0.99
977,26,-6.2,144,108197,0.99
978,20,-1.9,141,108338,0.99
979,28,-3.6,145,108483,0.99
980,19,-1.8,135,108618,0.99
981,24,-2.3,146,108764,0.99
982,29,-3.7,141,108905,0.99
983,17,-5.4,135,109040,0.99
984,28,-2.7,151,109191,0.99
985,24,-2.3,142,109333,0.99
986,25,-3.3,139,109472,0.99
987,26,-2.5,144,109616,0.99
988,19,-2.7,145,109761,0.99
989,36,-4.4,139,109900,0.99
990,20,-2.8,148,110048,0.99
991,18,-5.5,148,110196,0.99
992,24,-2.3,140,110336,0.99
993,17,-1.6,142,110478,0.99
994,20,-2.8,142,110620,0.99
995,20,-1.9,141,110761,0.99
996,21,-2,141,110902,0.99
997,20,-1.9,144,111046,0.99
998,22,-3,148,111194,0.99
999,22,-3,145,111339,0.99
1000,17,-1.6,143,111482,0.99
1001,37,-7.4,142,111624,0.99
1002,31,-4.8,145,111769,0.99
1003,22,-2.1,142,111911,0.99
1004,21,-2,145,112056,0.99
1005,23,-3.1,155,112211,0.99
1006,25,-2.4,150,112361,0.99
1007,49,-12.4,153,112514,0.99
1008,17,-1.6,147,112661,0.99
1009,24,-2.3,151,112812,0.99
1010,20,-1.9,146,112958,0.99
1011,18,-1.7,153,113111,0.99
1012,22,-2.1,147,113258,0.99
1013,30,-10.5,146,113404,0.99
1014,23,-6.9,144,113548,0.99
1015,21,-2,138,113686,0.99
1016,18,-1.7,149,113835,0.99
1017,31,-3.9,148,113983,0.99
1018,23,-3.1,152,114135,0.99
1019,20,-1.9,141,114276,0.99
1020,41,-4.9,146,114422,0.99
1021,19,-2.7,146,114568,0.99
1022,21,-2.9,146,114714,0.99
1023,25,-4.3,142,114856,0.99
1024,21,-3.9,153,115009,0.99
1025,19,-1.8,161,115170,0.99
1026,17,-3.5,145,115315,0.99
1027,23,-2.2,148,115463,0.99
1028,20,-1.9,147,115610,0.99
1029,20,-2.8,145,115755,0.99
1030,20,-1.9,145,115900,0.99
1031,19,-1.8,146,116046,0.99
1032,26,-2.5,154,116200,0.99
1033,25,-3.3,153,116353,0.99
1034,26,-2.5,144,116497,0.99
1035,25,-3.3,143,116640,0.99
1036,38,-4.6,145,116785,0.99
1037,19,-1.8,140,116925,0.99
1038,23,-2.2,146,117071,0.99
1039,29,-5.5,155,117226,0.99
1040,21,-2,144,117370,0.99
1041,27,-3.5,154,117524,0.99
1042,21,-2,149,117673,0.99
1043,27,-5.4,149,117822,0.99
1044,21,-2,145,117967,0.99
1045,20,-1.9,151,118118,0.99
1046,23,-2.2,149,118267,0.99
1047,17,-1.6,146,118413,0.99
1048,29,-3.7,146,118559,0.99
1049,20,-2.8,148,118707,0.99
1050,33,-5.1,149,118856,0.99
1051,21,-2,151,119007,0.99
1052,23,-2.2,152,119159,0.99
1053,31,-4.9,149,119308,0.99
1054,17,-2.5,147,119455,0.99
1055,26,-2.5,149,119604,0.99
1056,29,-2.8,144,119748,0.99
1057,16,-1.5,148,119896,0.99
1058,21,-2.9,146,120042,0.99
1059,28,-2.7,151,120193,0.99
1060,25,-3.3,152,120345,0.99
1061,25,-3.3,155,120500,0.99
1062,25,-3.3,155,120655,0.99
1063,17,-2.5,156,120811,0.99
1064,17,-3.5,149,120960,0.99
1065,21,-2,163,121123,0.99
1066,27,-2.6,162,121285,0.99
1067,21,-2,179,121464,0.99
1068,21,-4.8,164,121628,0.99
1069,21,-2,153,121781,0.99
1070,25,-3.3,145,121926,0.99
1071,37,-4.5,151,122077,0.99
1072,24,-2.3,149,122226,0.99
1073,32,-4,149,122375,0.99
1074,21,-2,145,122520,0.99
1075,21,-4.8,150,122670,0.99
1076,18,-1.7,151,122821,0.99
1077,24,-4.1,149,122970,0.99
1078,23,-3.1,154,123124,0.99
1079,20,-1.9,143,123267,0.99
1080,20,-1.9,145,123412,0.99
1081,20,-2.8,141,123553,0.99
1082,41,-7.8,150,123703,0.99
1083,28,-4.6,146,123849,0.99
1084,22,-2.1,144,123993,0.99
1085,30,-3.8,157,124150,0.99
1086,23,-2.2,143,124293,0.99
1087,27,-2.6,151,124444,0.99
1088,24,-2.3,146,124590,0.99
1089,29,-2.8,146,124736,0.99
1090,18,-1.7,153,124889,0.99
1091,16,-1.5,146,125035,0.99
1092,22,-3.9,152,125187,0.99
1093,19,-3.7,149,125336,0.99
1094,27,-2.6,146,125482,0.99
1095,25,-4.3,151,125633,0.99
1096,19,-3.7,147,125780,0.99
1097,22,-2.1,151,125931,0.99
1098,21,-3.8,156,126087,0.99
1099,19,-1.8,144,126231,0.99
1100,33,-3.2,152,126383,0.99
1101,26,-3.4,146,126529,0.99
1102,17,-3.4,146,126675,0.99
1103,23,-2.2,149,126824,0.99
1104,18,-1.7,149,126973,0.99
1105,22,-2.1,156,127129,0.99
1106,28,-3.6,149,127278,0.99
1107,64,-6.3,152,127430,0.99
1108,17,-1.6,155,127585,0.99
1109,26,-2.5,151,127736,0.99
1110,28,-2.7,154,127890,0.99
1111,26,-2.5,152,128042,0.99
1112,19,-1.8,155,128197,0.99
1113,26,-3.4,150,128347,0.99
1114,22,-2.1,152,128499,0.99
1115,16,-1.5,147,128646,0.99
1116,26,-17.9,153,128799,0.99
1117,25,-4.3,150,128949,0.99
1118,20,-2.8,160,129109,0.99
1119,24,-2.3,152,129261,0.99
1120,27,-3.5,149,129410,0.99
1121,26,-3.4,153,129563,0.99
1122,25,-3.3,148,129711,0.99
1123,25,-4.3,151,129862,0.99
1124,25,-6.2,143,130005,0.99
1125,64,-12,160,130165,0.99
1126,25,-5.2,152,130317,0.99
1127,22,-2.1,148,130465,0.99
1128,27,-3.5,149,130614,0.99
1129,17,-3.5,152,130766,0.99
1130,21,-2,149,130915,0.99
1131,21,-2,161,131076,0.99
1132,23,-3.1,151,131227,0.99
1133,19,-1.8,153,131380,0.99
1134,27,-3.5,146,131526,0.99
1135,27,-4.5,150,131676,0.99
1136,19,-1.8,149,131825,0.99
1137,23,-4,152,131977,0.99
1138,58,-6.6,151,132128,0.99
1139,19,-1.8,149,132277,0.99
1140,17,-1.6,159,132436,0.99
1141,23,-4,153,132589,0.99
1142,19,-2.7,156,132745,0.99
1143,20,-1.9,154,132899,0.99
1144,20,-1.9,154,133053,0.99
1145,26,-2.5,154,133207,0.99
1146,64,-6.3,152,133359,0.99
1147,21,-4.8,157,133516,0.99
1148,22,-3,151,133667,0.99
1149,24,-2.3,159,133826,0.99
1150,24,-3.2,152,133978,0.99
1151,22,-3,164,134142,0.99
1152,26,-10.1,154,134296,0.99
1153,45,-4.4,152,134448,0.99
1154,23,-4.1,151,134599,0.99
1155,31,-3,148,134747,0.99
1156,23,-2.2,156,134903,0.99
1157,19,-1.8,157,135060,0.99
1158,31,-3.9,155,135215,0.99
1159,23,-2.2,148,135363,0.99
1160,20,-1.9,152,135515,0.99
1161,24,-2.3,156,135671,0.99
1162,27,-2.6,150,135821,0.99
1163,18,-2.6,147,135968,0.99
1164,53,-6.1,164,136132,0.99
1165,18,-2.6,152,136284,0.99
1166,25,-2.4,151,136435,0.99
1167,16,-1.5,149,136584,0.99
1168,21,-2.9,158,136742,0.99
1169,26,-2.5,157,136899,0.99
1170,23,-2.2,160,137059,0.99
1171,31,-9.6,165,137224,0.99
1172,19,-1.8,150,137374,0.99
1173,17,-1.6,160,137534,0.99
1174,20,-3.8,157,137691,0.99
1175,64,-6.3,152,137843,0.99
1176,26,-2.5,157,138000,0.99
1177,29,-3.7,166,138166,0.99
1178,22,-2.1,158,138324,0.99
1179,21,-2,160,138484,0.99
1180,20,-2.8,151,138635,0.99
1181,21,-3.9,155,138790,0.99
1182,22,-3,158,138948,0.99
1183,40,-3.9,163,139111,0.99
1184,19,-1.8,155,139266,0.99
1185,18,-2.6,153,139419,0.99
1186,20,-2.8,153,139572,0.99
1187,21,-2,153,139725,0.99
1188,20,-2.8,161,139886,0.99
1189,15,-3.3,161,140047,0.99
1190,21,-2,155,140202,0.99
1191,27,-3.5,155,140357,0.99
1192,21,-3.9,154,140511,0.99
1193,18,-2.6,165,140676,0.99
1194,54,-5.3,159,140835,0.99
1195,45,-4.4,160,140995,0.99
1196,19,-1.8,163,141158,0.99
1197,18,-1.7,157,141315,0.99
1198,26,-3.4,160,141475,0.99
1199,17,-6.3,150,141625,0.99
1200,17,-2.5,156,141781,0.99
1201,19,-2.7,152,141933,0.99
1202,23,-6,167,142100,0.99
1203,37,-7.3,160,142260,0.99
1204,31,-3,162,142422,0.99
1205,64,-6.3,163,142585,0.99
1206,18,-1.7,158,142743,0.99
1207,15,-1.4,156,142899,0.99
1208,29,-2.8,166,143065,0.99
1209,21,-6.7,152,143217,0.99
1210,25,-2.4,160,143377,0.99
1211,22,-2.1,155,143532,0.99
1212,17,-2.5,160,143692,0.99
1213,20,-3.8,153,143845,0.99
1214,27,-2.6,170,144015,0.99
1215,18,-1.7,160,144175,0.99
1216,30,-3.8,155,144330,0.99
1217,38,-3.7,152,144482,0.99
1218,24,-4.1,154,144636,0.99
1219,18,-1.7,160,144796,0.99
1220,27,-3.5,160,144956,0.99
1221,21,-2.9,167,145123,0.99
1222,20,-1.9,157,145280,0.99
1223,18,-2.6,156,145436,0.99
1224,21,-2.9,197,145633,0.99
1225,26,-2.5,154,145787,0.99
1226,24,-3.2,159,145946,0.99
1227,27,-2.6,166,146112,0.99
1228,19,-2.7,209,146321,0.99
1229,31,-3,204,146525,0.99
1230,22,-3.9,175,146700,0.99
1231,56,-8.3,160,146860,0.99
1232,28,-2.7,190,147050,0.99
1233,27,-3.5,181,147231,0.99
1234,31,-4.8,170,147401,0.99
1235,22,-2.1,159,147560,0.99
1236,19,-1.8,164,147724,0.99
1237,17,-4.4,158,147882,0.99
1238,20,-3.8,163,148045,0.99
1239,18,-2.6,161,148206,0.99
1240,22,-2.1,162,148368,0.99
1241,21,-2,161,148529,0.99
1242,17,-1.6,160,148689,0.99
1243,17,-4.4,149,148838,0.99
1244,24,-2.3,163,149001,0.99
1245,16,-1.5,159,149160,0.99
1246,30,-2.9,156,149316,0.99
1247,16,-1.5,158,149474,0.99
1248,25,-2.4,157,149631,0.99
1249,21,-2.9,160,149791,0.99
1250,25,-2.4,160,149951,0.99
1251,23,-2.2,178,150129,0.99
1252,20,-1.9,157,150286,0.99
1253,22,-3,159,150445,0.99
1254,22,-2.1,166,150611,0.99
1255,21,-2,157,150768,0.99
1256,25,-3.3,163,150931,0.99
1257,22,-2.1,186,151117,0.99
1258,31,-3,160,151277,0.99
1259,46,-5.4,155,151432,0.99
1260,17,-1.6,157,151589,0.99
1261,17,-1.6,159,151748,0.99
1262,19,-3.7,162,151910,0.99
1263,24,-3.2,177,152087,0.99
1264,38,-5.5,163,152250,0.99
1265,27,-2.6,163,152413,0.99
1266,23,-2.2,167,152580,0.99
1267,25,-3.3,162,152742,0.99
1268,20,-2.8,167,152909,0.99
1269,64,-7.2,167,153076,0.99
1270,22,-3,156,153232,0.99
1271,31,-3.9,158,153390,0.99
1272,19,-2.7,159,153549,0.99
1273,19,-1.8,162,153711,0.99
1274,18,-5.4,164,153875,0.99
1275,23,-2.2,169,154044,0.99
1276,16,-3.4,161,154205,0.99
1277,20,-2.8,163,154368,0.99
1278,21,-2,163,154531,0.99
1279,24,-2.3,159,154690,0.99
1280,24,-3.2,163,154853,0.99
1281,21,-2,164,155017,0.99
1282,31,-8.7,160,155177,0.99
1283,18,-1.7,159,155336,0.99
1284,20,-1.9,160,155496,0.99
1285,27,-5.5,164,155660,0.99
1286,20,-1.9,164,155824,0.99
1287,29,-3.7,166,155990,0.99
1288,25,-5.1,157,156147,0.99
1289,24,-2.3,168,156315,0.99
1290,27,-4.5,170,156485,0.99
1291,20,-1.9,164,156649,0.99
1292,19,-3.7,164,156813,0.99
1293,19,-2.7,170,156983,0.99
1294,25,-7.2,165,157148,0.99
1295,22,-2.1,170,157318,0.99
1296,48,-6.6,168,157486,0.99
1297,21,-2,174,157660,0.99
1298,23,-3.1,164,157824,0.99
1299,20,-1.9,169,157993,0.99
1300,22,-2.1,167,158160,0.99
1301,21,-2,161,158321,0.99
1302,25,-3.3,161,158482,0.99
1303,27,-3.5,163,158645,0.99
1304,21,-2,163,158808,0.99
1305,25,-2.4,168,158976,0.99
1306,27,-6.4,171,159147,0.99
1307,20,-2.8,161,159308,0.99
1308,19,-1.8,158,159466,0.99
1309,24,-3.2,164,159630,0.99
1310,19,-2.7,164,159794,0.99
1311,19,-1.8,172,159966,0.99
1312,42,-5,160,160126,0.99
1313,23,-2.2,159,160285,0.99
1314,22,-2.1,166,160451,0.99
1315,30,-2.9,168,160619,0.99
1316,19,-1.8,162,160781,0.99
1317,38,-12.4,171,160952,0.99
1318,20,-1.9,166,161118,0.99
1319,20,-1.9,163,161281,0.99
1320,22,-3,163,161444,0.99
1321,21,-2.9,166,161610,0.99
1322,28,-2.7,165,161775,0.99
1323,20,-1.9,165,161940,0.99
1324,25,-5.2,163,162103,0.99
1325,23,-2.2,170,162273,0.99
1326,25,-4.2,174,162447,0.99
1327,21,-2,164,162611,0.99
1328,21,-2,163,162774,0.99
1329,22,-3,166,162940,0.99
1330,25,-2.4,163,163103,0.99
1331,22,-3,161,163264,0.99
1332,27,-2.6,165,163429,0.99
1333,24,-3.2,167,163596,0.99
1334,23,-2.2,164,163760,0.99
1335,20,-2.8,167,163927,0.99
1336,22,-2.1,173,164100,0.99
1337,26,-3.4,168,164268,0.99
1338,19,-2.7,167,164435,0.99
1339,18,-2.6,169,164604,0.99
1340,25,-2.4,165,164769,0.99
1341,23,-2.2,177,164946,0.99
1342,20,-3.8,164,165110,0.99
1343,23,-3.1,167,165277,0.99
1344,22,-2.1,166,165443,0.99
1345,26,-3.4,169,165612,0.99
1346,26,-9.2,163,165775,0.99
1347,23,-4,169,165944,0.99
1348,22,-4,172,166116,0.99
1349,18,-1.7,167,166283,0.99
1350,26,-2.5,162,166445,0.99
1351,22,-2.1,174,166619,0.99
1352,51,-5.9,170,166789,0.99
1353,21,-2,186,166975,0.99
1354,24,-5.1,161,167136,0.99
1355,20,-1.9,177,167313,0.99
1356,20,-2.8,170,167483,0.99
1357,26,-3.4,199,167682,0.99
1358,28,-2.7,169,167851,0.99
1359,20,-1.9,174,168025,0.99
1360,22,-3,171,168196,0.99
1361,22,-3,168,168364,0.99
1362,52,-5.1,179,168543,0.99
1363,24,-2.3,171,168714,0.99
1364,20,-1.9,292,169006,0.99
1365,21,-2,246,169252,0.99
1366,24,-2.3,190,169442,0.99
1367,24,-4.2,193,169635,0.99
1368,23,-2.2,200,169835,0.99
1369,21,-2.9,191,170026,0.99
1370,20,-1.9,213,170239,0.99
1371,20,-1.9,195,170434,0.99
1372,21,-2,190,170624,0.99
1373,21,-2,168,170792,0.99
1374,63,-8,171,170963,0.99
1375,21,-2,163,171126,0.99
1376,23,-3.1,166,171292,0.99
1377,30,-3.8,176,171468,0.99
1378,24,-2.3,173,171641,0.99
1379,41,-4.9,171,171812,0.99
1380,27,-2.6,182,171994,0.99
1381,23,-2.2,171,172165,0.99
1382,19,-1.8,171,172336,0.99
1383,25,-2.4,170,172506,0.99
1384,24,-3.2,169,172675,0.99
1385,35,-11.9,168,172843,0.99
1386,26,-3.4,177,173020,0.99
1387,20,-1.9,167,173187,0.99
1388,17,-1.6,192,173379,0.99
1389,26,-4.3,174,173553,0.99
1390,22,-2.1,185,173738,0.99
1391,22,-3.9,190,173928,0.99
1392,23,-4,171,174099,0.99
1393,26,-4.3,180,174279,0.99
1394,16,-3.4,297,174576,0.99
1395,22,-4,200,174776,0.99
1396,64,-6.3,190,174966,0.99
1397,16,-3.3,204,175170,0.99
1398,21,-2,184,175354,0.99
1399,24,-3.2,180,175534,0.99
1400,25,-2.4,176,175710,0.99
1401,21,-2.9,176,175886,0.99
1402,21,-2,179,176065,0.99
1403,19,-1.8,175,176240,0.99
1404,27,-3.5,170,176410,0.99
1405,38,-3.7,177,176587,0.99
1406,24,-2.3,172,176759,0.99
1407,25,-2.4,177,176936,0.99
1408,24,-3.2,174,177110,0.99
1409,26,-2.5,223,177333,0.99
1410,23,-2.2,206,177539,0.99
1411,32,-3.1,185,177724,0.99
1412,21,-3.9,191,177915,0.99
1413,24,-8.1,186,178101,0.99
1414,23,-5.1,167,178268,0.99
1415,26,-2.5,195,178463,0.99
1416,20,-1.9,192,178655,0.99
1417,64,-6.3,180,178835,0.99
1418,23,-2.2,178,179013,0.99
1419,22,-2.1,170,179183,0.99
1420,27,-2.6,180,179363,0.99
1421,22,-3,193,179556,0.99
1422,41,-5.8,176,179732,0.99
1423,24,-3.2,187,179919,0.99
1424,23,-2.2,192,180111,0.99
1425,19,-1.8,178,180289,0.99
1426,20,-2.8,180,180469,0.99
1427,36,-5.4,182,180651,0.99
1428,23,-2.2,183,180834,0.99
1429,23,-2.2,188,181022,0.99
1430,23,-4,176,181198,0.99
1431,19,-1.8,175,181373,0.99
1432,18,-1.7,172,181545,0.99
1433,21,-2.9,175,181720,0.99
1434,64,-6.3,185,181905,0.99
1435,21,-2,184,182089,0.99
1436,64,-6.3,181,182270,0.99
1437,18,-2.6,171,182441,0.99
1438,26,-2.5,181,182622,0.99
1439,34,-4.2,178,182800,0.99
1440,43,-5.1,183,182983,0.99
1441,29,-4.7,176,183159,0.99
1442,17,-1.6,176,183335,0.99
1443,19,-1.8,174,183509,0.99
1444,25,-2.4,170,183679,0.99
1445,22,-2.1,170,183849,0.99
1446,28,-2.7,178,184027,0.99
1447,29,-2.8,177,184204,0.99
1448,18,-1.7,183,184387,0.99
1449,19,-2.7,182,184569,0.99
1450,21,-5.8,176,184745,0.99
1451,24,-2.3,180,184925,0.99
1452,26,-2.5,172,185097,0.99
1453,28,-2.7,175,185272,0.99
1454,18,-3.5,182,185454,0.99
1455,24,-2.3,178,185632,0.99
1456,28,-4.5,175,185807,0.99
1457,21,-2,195,186002,0.99
1458,23,-3.1,237,186239,0.99
1459,64,-6.3,182,186421,0.99
1460,20,-1.9,177,186598,0.99
1461,25,-2.4,182,186780,0.99
1462,24,-3.2,206,186986,0.99
1463,17,-3.5,184,187170,0.99
1464,22,-3,186,187356,0.99
1465,27,-2.6,180,187536,0.99
1466,17,-2.5,186,187722,0.99
1467,24,-5,220,187942,0.99
1468,25,-2.4,181,188123,0.99
1469,19,-1.8,178,188301,0.99
1470,19,-2.7,204,188505,0.99
1471,23,-2.2,191,188696,0.99
1472,24,-4.2,183,188879,0.99
1473,25,-2.4,183,189062,0.99
1474,31,-3,176,189238,0.99
1475,22,-2.1,179,189417,0.99
1476,26,-2.5,180,189597,0.99
1477,20,-1.9,184,189781,0.99
1478,31,-3,212,189993,0.99
1479,19,-1.8,178,190171,0.99
1480,18,-1.7,179,190350,0.99
1481,19,-1.8,180,190530,0.99
1482,22,-2.1,174,190704,0.99
1483,18,-3.6,193,190897,0.99
1484,18,-3.6,171,191068,0.99
1485,24,-2.3,195,191263,0.99
1486,17,-1.6,175,191438,0.99
1487,22,-3,191,191629,0.99
1488,20,-1.9,183,191812,0.99
1489,20,-2.8,196,192008,0.99
1490,27,-3.5,185,192193,0.99
1491,18,-1.7,193,192386,0.99
1492,35,-5.2,200,192586,0.99
1493,21,-2,192,192778,0.99
1494,16,-1.5,192,192970,0.99
1495,25,-3.3,184,193154,0.99
1496,24,-2.3,179,193333,0.99
1497,23,-2.2,183,193516,0.99
1498,22,-2.1,187,193703,0.99
1499,29,-2.8,192,193895,0.99
1500,20,-1.9,181,194076,0.99
