1,100,-9.9,79,79,0.99
2,100,-9.9,68,147,0.99
3,100,-9.9,22,169,0.99
4,100,-9.9,49,218,0.99
5,100,-9.9,61,279,0.99
6,100,-9.9,64,343,0.99
7,100,-9.9,39,382,0.99
8,100,-9.9,34,416,0.99
9,100,-9.9,32,448,0.99
10,100,-9.9,41,489,0.99
11,100,-9.9,53,542,0.99
12,100,-9.9,161,703,0.99
13,100,-9.9,72,775,0.99
14,100,-9.9,69,844,0.99
15,100,-9.9,63,907,0.99
16,100,-9.9,93,1000,0.99
17,100,-9.9,198,1198,0.99
18,100,-9.9,127,1325,0.99
19,100,-9.9,135,1460,0.99
20,100,-9.9,135,1595,0.99
21,100,-9.9,48,1643,0.99
22,100,-9.9,59,1702,0.99
23,100,-9.9,38,1740,0.99
24,100,-9.9,44,1784,0.99
25,100,-9.9,34,1818,0.99
26,100,-9.9,36,1854,0.99
27,100,-9.9,45,1899,0.99
28,100,-9.9,65,1964,0.99
29,100,-9.9,61,2025,0.99
30,100,-9.9,71,2096,0.99
31,100,-9.9,60,2156,0.99
32,100,-9.9,43,2199,0.99
33,100,-9.9,51,2250,0.99
34,100,-9.9,46,2296,0.99
35,100,-9.9,46,2342,0.99
36,100,-9.9,47,2389,0.99
37,100,-9.9,54,2443,0.99
38,100,-9.9,58,2501,0.99
39,100,-9.9,54,2555,0.99
40,100,-9.9,60,2615,0.99
41,100,-9.9,60,2675,0.99
42,100,-9.9,56,2731,0.99
43,100,-9.9,79,2810,0.99
44,100,-9.9,90,2900,0.99
45,100,-9.9,87,2987,0.99
46,100,-9.9,61,3048,0.99
47,100,-9.9,64,3112,0.99
48,100,-9.9,60,3172,0.99
49,100,-9.9,57,3229,0.99
50,100,-9.9,57,3286,0.99
51,100,-9.9,61,3347,0.99
52,100,-9.9,60,3407,0.99
53,100,-9.9,68,3475,0.99
54,100,-9.9,58,3533,0.99
55,100,-9.9,66,3599,0.99
56,100,-9.9,68,3667,0.99
57,100,-9.9,67,3734,0.99
58,100,-9.9,63,3797,0.99
59,100,-9.9,69,3866,0.99
60,100,-9.9,65,3931,0.99
61,100,-9.9,66,3997,0.99
62,100,-9.9,66,4063,0.99
63,100,-9.9,68,4131,0.99
64,100,-9.9,70,4201,0.99
65,100,-9.9,77,4278,0.99
66,100,-9.9,73,4351,0.99
67,100,-9.9,70,4421,0.99
68,100,-9.9,73,4494,0.99
69,100,-9.9,79,4573,0.99
70,100,-9.9,67,4640,0.99
71,100,-9.9,74,4714,0.99
72,100,-9.9,70,4784,0.99
73,100,-9.9,75,4859,0.99
74,100,-9.9,79,4938,0.99
75,100,-9.9,74,5012,0.99
76,100,-9.9,81,5093,0.99
77,100,-9.9,83,5176,0.99
78,100,-9.9,85,5261,0.99
79,100,-9.9,77,5338,0.99
80,100,-9.9,78,5416,0.99
81,100,-9.9,78,5494,0.99
82,100,-9.9,88,5582,0.99
83,100,-9.9,78,5660,0.99
84,100,-9.9,82,5742,0.99
85,100,-9.9,83,5825,0.99
86,100,-9.9,87,5912,0.99
87,100,-9.9,92,6004,0.99
88,100,-9.9,86,6090,0.99
89,100,-9.9,86,6176,0.99
90,100,-9.9,83,6259,0.99
91,100,-9.9,87,6346,0.99
92,100,-9.9,80,6426,0.99
93,100,-9.9,88,6514,0.99
94,100,-9.9,94,6608,0.99
95,100,-9.9,91,6699,0.99
96,100,-9.9,87,6786,0.99
97,100,-9.9,91,6877,0.99
98,100,-9.9,86,6963,0.99
99,100,-9.9,89,7052,0.99
100,100,-9.9,93,7145,0.99
101,100,-9.9,90,7235,0.99
102,100,-9.9,86,7321,0.99
103,100,-9.9,87,7408,0.99
104,100,-9.9,91,7499,0.99
105,100,-9.9,89,7588,0.99
106,100,-9.9,87,7675,0.99
107,100,-9.9,92,7767,0.99
108,100,-9.9,93,7860,0.99
109,100,-9.9,95,7955,0.99
110,100,-9.9,89,8044,0.99
111,100,-9.9,95,8139,0.99
112,100,-9.9,93,8232,0.99
113,100,-9.9,90,8322,0.99
114,100,-9.9,95,8417,0.99
115,100,-9.9,93,8510,0.99
116,100,-9.9,101,8611,0.99
117,100,-9.9,97,8708,0.99
118,100,-9.9,93,8801,0.99
119,100,-9.9,93,8894,0.99
120,100,-9.9,97,8991,0.99
121,100,-9.9,96,9087,0.99
122,100,-9.9,92,9179,0.99
123,100,-9.9,98,9277,0.99
124,100,-9.9,96,9373,0.99
125,100,-9.9,98,9471,0.99
126,100,-9.9,104,9575,0.99
127,100,-9.9,101,9676,0.99
128,100,-9.9,104,9780,0.99
129,100,-9.9,100,9880,0.99
130,100,-9.9,101,9981,0.99
131,100,-9.9,101,10082,0.99
132,100,-9.9,104,10186,0.99
133,100,-9.9,107,10293,0.99
134,100,-9.9,98,10391,0.99
135,100,-9.9,102,10493,0.99
136,100,-9.9,111,10604,0.99
137,100,-9.9,101,10705,0.99
138,100,-9.9,103,10808,0.99
139,100,-9.9,106,10914,0.99
140,100,-9.9,103,11017,0.99
141,100,-9.9,104,11121,0.99
142,100,-9.9,107,11228,0.99
143,100,-9.9,109,11337,0.99
144,100,-9.9,103,11440,0.99
145,100,-9.9,114,11554,0.99
146,100,-9.9,107,11661,0.99
147,100,-9.9,105,11766,0.99
148,100,-9.9,110,11876,0.99
149,100,-9.9,109,11985,0.99
150,100,-9.9,110,12095,0.99
151,100,-9.9,110,12205,0.99
152,100,-9.9,110,12315,0.99
153,100,-9.9,110,12425,0.99
154,100,-9.9,116,12541,0.99
155,100,-9.9,111,12652,0.99
156,100,-9.9,112,12764,0.99
157,100,-9.9,108,12872,0.99
158,100,-9.9,107,12979,0.99
159,100,-9.9,111,13090,0.99
160,100,-9.9,111,13201,0.99
161,100,-9.9,114,13315,0.99
162,100,-9.9,113,13428,0.99
163,100,-9.9,117,13545,0.99
164,100,-9.9,113,13658,0.99
165,100,-9.9,114,13772,0.99
166,100,-9.9,110,13882,0.99
167,100,-9.9,112,13994,0.99
168,100,-9.9,112,14106,0.99
169,100,-9.9,114,14220,0.99
170,100,-9.9,111,14331,0.99
171,100,-9.9,116,14447,0.99
172,100,-9.9,119,14566,0.99
173,100,-9.9,112,14678,0.99
174,100,-9.9,118,14796,0.99
175,100,-9.9,118,14914,0.99
176,100,-9.9,118,15032,0.99
177,100,-9.9,116,15148,0.99
178,100,-9.9,120,15268,0.99
179,100,-9.9,116,15384,0.99
180,100,-9.9,120,15504,0.99
181,100,-9.9,119,15623,0.99
182,100,-9.9,115,15738,0.99
183,85,-8.4,120,15858,0.99
184,100,-9.9,114,15972,0.99
185,100,-9.9,118,16090,0.99
186,100,-9.9,118,16208,0.99
187,100,-9.9,120,16328,0.99
188,100,-9.9,123,16451,0.99
189,100,-9.9,126,16577,0.99
190,100,-9.9,120,16697,0.99
191,100,-9.9,123,16820,0.99
192,100,-9.9,117,16937,0.99
193,100,-9.9,122,17059,0.99
194,100,-9.9,118,17177,0.99
195,100,-9.9,124,17301,0.99
196,100,-9.9,119,17420,0.99
197,100,-9.9,125,17545,0.99
198,100,-9.9,120,17665,0.99
199,100,-9.9,123,17788,0.99
200,100,-9.9,119,17907,0.99
201,100,-9.9,124,18031,0.99
202,100,-9.9,122,18153,0.99
203,100,-9.9,121,18274,0.99
204,100,-9.9,119,18393,0.99
205,57,-5.6,130,18523,0.99
206,100,-9.9,126,18649,0.99
207,100,-9.9,127,18776,0.99
208,100,-9.9,125,18901,0.99
209,32,-3.1,122,19023,0.99
210,100,-9.9,125,19148,0.99
211,100,-9.9,126,19274,0.99
212,100,-9.9,127,19401,0.99
213,100,-9.9,130,19531,0.99
214,100,-9.9,129,19660,0.99
215,100,-9.9,121,19781,0.99
216,100,-9.9,124,19905,0.99
217,65,-6.4,127,20032,0.99
218,100,-9.9,125,20157,0.99
219,100,-9.9,127,20284,0.99
220,100,-9.9,123,20407,0.99
221,100,-9.9,130,20537,0.99
222,100,-9.9,125,20662,0.99
223,100,-9.9,125,20787,0.99
224,76,-7.5,129,20916,0.99
225,100,-9.9,127,21043,0.99
226,93,-9.2,125,21168,0.99
227,100,-9.9,132,21300,0.99
228,100,-9.9,127,21427,0.99
229,100,-9.9,132,21559,0.99
230,100,-9.9,128,21687,0.99
231,95,-9.4,129,21816,0.99
232,100,-9.9,129,21945,0.99
233,100,-9.9,130,22075,0.99
234,100,-9.9,130,22205,0.99
235,100,-9.9,131,22336,0.99
236,100,-9.9,130,22466,0.99
237,100,-9.9,136,22602,0.99
238,100,-9.9,128,22730,0.99
239,100,-9.9,131,22861,0.99
240,100,-9.9,130,22991,0.99
241,100,-9.9,133,23124,0.99
242,100,-9.9,130,23254,0.99
243,100,-9.9,129,23383,0.99
244,61,-6,139,23522,0.99
245,100,-9.9,133,23655,0.99
246,100,-9.9,133,23788,0.99
247,100,-9.9,136,23924,0.99
248,100,-9.9,132,24056,0.99
249,100,-9.9,136,24192,0.99
250,100,-9.9,133,24325,0.99
251,100,-9.9,138,24463,0.99
252,100,-9.9,137,24600,0.99
253,100,-9.9,131,24731,0.99
254,66,-6.5,132,24863,0.99
255,100,-9.9,134,24997,0.99
256,89,-8.8,135,25132,0.99
257,48,-4.7,135,25267,0.99
258,70,-6.9,132,25399,0.99
259,100,-9.9,134,25533,0.99
260,100,-9.9,133,25666,0.99
261,72,-7.1,138,25804,0.99
262,100,-9.9,136,25940,0.99
263,93,-9.2,136,26076,0.99
264,41,-4,132,26208,0.99
265,100,-9.9,133,26341,0.99
266,100,-9.9,140,26481,0.99
267,100,-9.9,135,26616,0.99
268,100,-9.9,138,26754,0.99
269,100,-9.9,135,26889,0.99
270,100,-9.9,133,27022,0.99
271,100,-9.9,138,27160,0.99
272,51,-5,140,27300,0.99
273,100,-9.9,139,27439,0.99
274,78,-7.7,141,27580,0.99
275,76,-7.5,136,27716,0.99
276,39,-3.8,138,27854,0.99
277,100,-9.9,139,27993,0.99
278,65,-6.4,140,28133,0.99
279,72,-7.1,141,28274,0.99
280,100,-9.9,136,28410,0.99
281,100,-9.9,140,28550,0.99
282,100,-9.9,140,28690,0.99
283,99,-9.8,142,28832,0.99
284,97,-9.6,140,28972,0.99
285,100,-9.9,138,29110,0.99
286,52,-5.1,140,29250,0.99
287,30,-2.9,137,29387,0.99
288,43,-4.2,142,29529,0.99
289,99,-9.8,142,29671,0.99
290,100,-9.9,142,29813,0.99
291,95,-9.4,141,29954,0.99
292,100,-9.9,139,30093,0.99
293,56,-5.5,143,30236,0.99
294,100,-9.9,143,30379,0.99
295,100,-9.9,148,30527,0.99
296,54,-5.3,142,30669,0.99
297,100,-9.9,143,30812,0.99
298,100,-9.9,141,30953,0.99
299,100,-9.9,145,31098,0.99
300,100,-9.9,140,31238,0.99
301,57,-5.6,140,31378,0.99
302,95,-9.4,144,31522,0.99
303,100,-9.9,143,31665,0.99
304,100,-9.9,144,31809,0.99
305,64,-6.3,139,31948,0.99
306,45,-4.4,143,32091,0.99
307,100,-9.9,142,32233,0.99
308,100,-9.9,145,32378,0.99
309,32,-3.1,145,32523,0.99
310,100,-9.9,143,32666,0.99
311,100,-9.9,147,32813,0.99
312,39,-3.8,145,32958,0.99
313,35,-3.4,143,33101,0.99
314,100,-9.9,145,33246,0.99
315,60,-5.9,143,33389,0.99
316,36,-3.5,147,33536,0.99
317,100,-9.9,144,33680,0.99
318,70,-6.9,146,33826,0.99
319,25,-2.4,145,33971,0.99
320,43,-4.2,146,34117,0.99
321,100,-9.9,146,34263,0.99
322,56,-5.5,146,34409,0.99
323,45,-4.4,151,34560,0.99
324,100,-9.9,147,34707,0.99
325,62,-6.1,149,34856,0.99
326,52,-5.1,145,35001,0.99
327,100,-9.9,146,35147,0.99
328,40,-3.9,146,35293,0.99
329,100,-9.9,151,35444,0.99
330,72,-7.1,145,35589,0.99
331,72,-7.1,147,35736,0.99
332,100,-9.9,146,35882,0.99
333,41,-4,146,36028,0.99
334,100,-9.9,145,36173,0.99
335,100,-9.9,148,36321,0.99
336,89,-8.8,154,36475,0.99
337,100,-9.9,145,36620,0.99
338,100,-9.9,147,36767,0.99
339,76,-7.5,147,36914,0.99
340,72,-7.1,146,37060,0.99
341,100,-9.9,150,37210,0.99
342,86,-8.5,149,37359,0.99
343,100,-9.9,150,37509,0.99
344,70,-6.9,150,37659,0.99
345,62,-6.1,148,37807,0.99
346,100,-9.9,152,37959,0.99
347,34,-3.3,151,38110,0.99
348,64,-6.3,151,38261,0.99
349,100,-9.9,149,38410,0.99
350,27,-2.6,150,38560,0.99
351,89,-8.8,147,38707,0.99
352,22,-2.1,149,38856,0.99
353,100,-9.9,147,39003,0.99
354,32,-3.1,151,39154,0.99
355,26,-2.5,152,39306,0.99
356,69,-6.8,156,39462,0.99
357,100,-9.9,149,39611,0.99
358,89,-8.8,151,39762,0.99
359,100,-9.9,153,39915,0.99
360,27,-2.6,151,40066,0.99
361,100,-9.9,153,40219,0.99
362,100,-9.9,150,40369,0.99
363,100,-9.9,156,40525,0.99
364,100,-9.9,145,40670,0.99
365,22,-2.1,152,40822,0.99
366,100,-9.9,153,40975,0.99
367,32,-3.1,149,41124,0.99
368,76,-7.5,152,41276,0.99
369,100,-9.9,155,41431,0.99
370,57,-5.6,153,41584,0.99
371,63,-6.2,151,41735,0.99
372,100,-9.9,152,41887,0.99
373,74,-7.3,156,42043,0.99
374,49,-4.8,154,42197,0.99
375,100,-9.9,153,42350,0.99
376,48,-4.7,157,42507,0.99
377,29,-2.8,156,42663,0.99
378,100,-9.9,152,42815,0.99
379,100,-9.9,153,42968,0.99
380,100,-9.9,152,43120,0.99
381,60,-5.9,150,43270,0.99
382,100,-9.9,155,43425,0.99
383,33,-3.2,155,43580,0.99
384,100,-9.9,155,43735,0.99
385,67,-6.6,151,43886,0.99
386,100,-9.9,153,44039,0.99
387,32,-3.1,157,44196,0.99
388,100,-9.9,159,44355,0.99
389,78,-7.7,164,44519,0.99
390,60,-5.9,151,44670,0.99
391,34,-3.3,157,44827,0.99
392,27,-2.6,159,44986,0.99
393,81,-8,158,45144,0.99
394,33,-3.2,156,45300,0.99
395,36,-3.5,158,45458,0.99
396,100,-9.9,156,45614,0.99
397,32,-3.1,158,45772,0.99
398,39,-3.8,154,45926,0.99
399,88,-8.7,156,46082,0.99
400,26,-2.5,158,46240,0.99
401,100,-9.9,161,46401,0.99
402,51,-5,159,46560,0.99
403,97,-9.6,154,46714,0.99
404,86,-8.5,158,46872,0.99
405,36,-3.5,160,47032,0.99
406,29,-2.8,158,47190,0.99
407,100,-9.9,157,47347,0.99
408,41,-4,162,47509,0.99
409,100,-9.9,158,47667,0.99
410,35,-3.4,155,47822,0.99
411,39,-3.8,156,47978,0.99
412,100,-9.9,158,48136,0.99
413,71,-7,158,48294,0.99
414,100,-9.9,166,48460,0.99
415,100,-9.9,158,48618,0.99
416,27,-2.6,159,48777,0.99
417,100,-9.9,154,48931,0.99
418,100,-9.9,157,49088,0.99
419,33,-3.2,159,49247,0.99
420,68,-6.7,162,49409,0.99
421,78,-7.7,159,49568,0.99
422,25,-2.4,159,49727,0.99
423,100,-9.9,163,49890,0.99
424,56,-5.5,159,50049,0.99
425,38,-3.7,166,50215,0.99
426,23,-2.2,160,50375,0.99
427,53,-5.2,163,50538,0.99
428,51,-5,157,50695,0.99
429,21,-2,159,50854,0.99
430,75,-7.4,158,51012,0.99
431,98,-9.7,162,51174,0.99
432,52,-5.1,159,51333,0.99
433,23,-2.2,165,51498,0.99
434,100,-9.9,160,51658,0.99
435,38,-3.7,163,51821,0.99
436,35,-3.4,161,51982,0.99
437,87,-8.6,159,52141,0.99
438,35,-3.4,162,52303,0.99
439,100,-9.9,168,52471,0.99
440,22,-2.1,161,52632,0.99
441,100,-9.9,162,52794,0.99
442,51,-5,162,52956,0.99
443,54,-5.3,162,53118,0.99
444,99,-9.8,158,53276,0.99
445,76,-7.5,163,53439,0.99
446,100,-9.9,158,53597,0.99
447,65,-6.4,161,53758,0.99
448,100,-9.9,160,53918,0.99
449,22,-2.1,163,54081,0.99
450,100,-9.9,162,54243,0.99
451,25,-2.4,166,54409,0.99
452,50,-4.9,161,54570,0.99
453,33,-3.2,159,54729,0.99
454,25,-2.4,163,54892,0.99
455,33,-3.2,167,55059,0.99
456,77,-7.6,164,55223,0.99
457,27,-2.6,172,55395,0.99
458,48,-4.7,167,55562,0.99
459,35,-3.4,164,55726,0.99
460,33,-3.2,167,55893,0.99
461,100,-9.9,163,56056,0.99
462,100,-9.9,171,56227,0.99
463,100,-9.9,169,56396,0.99
464,100,-9.9,163,56559,0.99
465,70,-6.9,166,56725,0.99
466,40,-3.9,164,56889,0.99
467,29,-2.8,164,57053,0.99
468,98,-9.7,168,57221,0.99
469,34,-3.3,163,57384,0.99
470,28,-2.7,165,57549,0.99
471,100,-9.9,164,57713,0.99
472,80,-7.9,167,57880,0.99
473,100,-9.9,165,58045,0.99
474,25,-2.4,164,58209,0.99
475,37,-3.6,170,58379,0.99
476,31,-3,165,58544,0.99
477,43,-4.2,167,58711,0.99
478,77,-7.6,165,58876,0.99
479,67,-6.6,168,59044,0.99
480,24,-2.3,166,59210,0.99
481,50,-4.9,175,59385,0.99
482,43,-4.2,168,59553,0.99
483,23,-2.2,166,59719,0.99
484,32,-3.1,168,59887,0.99
485,100,-9.9,169,60056,0.99
486,25,-2.4,167,60223,0.99
487,27,-2.6,175,60398,0.99
488,25,-2.4,170,60568,0.99
489,36,-3.5,168,60736,0.99
490,78,-7.7,167,60903,0.99
491,27,-2.6,163,61066,0.99
492,100,-9.9,167,61233,0.99
493,26,-2.5,173,61406,0.99
494,82,-8.1,168,61574,0.99
495,39,-3.8,167,61741,0.99
496,40,-3.9,170,61911,0.99
497,31,-3,168,62079,0.99
498,64,-6.3,168,62247,0.99
499,77,-7.6,170,62417,0.99
500,53,-5.2,168,62585,0.99
501,57,-5.6,169,62754,0.99
502,23,-2.2,171,62925,0.99
503,50,-4.9,168,63093,0.99
504,25,-2.4,169,63262,0.99
505,25,-2.4,171,63433,0.99
506,30,-2.9,171,63604,0.99
507,75,-7.4,168,63772,0.99
508,100,-9.9,171,63943,0.99
509,96,-9.5,166,64109,0.99
510,22,-2.1,168,64277,0.99
511,76,-7.5,176,64453,0.99
512,22,-2.1,169,64622,0.99
513,22,-2.1,172,64794,0.99
514,31,-3,170,64964,0.99
515,26,-2.5,172,65136,0.99
516,50,-4.9,170,65306,0.99
517,23,-2.2,177,65483,0.99
518,32,-3.1,168,65651,0.99
519,32,-3.1,168,65819,0.99
520,37,-3.6,170,65989,0.99
521,21,-2,170,66159,0.99
522,28,-2.7,180,66339,0.99
523,43,-4.2,172,66511,0.99
524,47,-4.6,169,66680,0.99
525,21,-2,175,66855,0.99
526,26,-2.5,171,67026,0.99
527,24,-2.3,171,67197,0.99
528,27,-2.6,176,67373,0.99
529,25,-2.4,170,67543,0.99
530,33,-3.2,173,67716,0.99
531,24,-2.3,173,67889,0.99
532,57,-5.6,170,68059,0.99
533,34,-3.3,172,68231,0.99
534,33,-3.2,181,68412,0.99
535,23,-2.2,170,68582,0.99
536,24,-2.3,172,68754,0.99
537,64,-6.3,173,68927,0.99
538,26,-2.5,172,69099,0.99
539,40,-3.9,174,69273,0.99
540,19,-1.8,173,69446,0.99
541,55,-5.4,174,69620,0.99
542,32,-3.1,177,69797,0.99
543,24,-2.3,175,69972,0.99
544,33,-3.2,170,70142,0.99
545,28,-2.7,177,70319,0.99
546,27,-2.6,173,70492,0.99
547,44,-4.3,172,70664,0.99
548,57,-5.6,171,70835,0.99
549,30,-2.9,172,71007,0.99
550,28,-2.7,175,71182,0.99
551,28,-2.7,176,71358,0.99
552,100,-9.9,172,71530,0.99
553,25,-2.4,173,71703,0.99
554,61,-6,173,71876,0.99
555,40,-3.9,172,72048,0.99
556,22,-2.1,173,72221,0.99
557,30,-2.9,177,72398,0.99
558,44,-4.3,175,72573,0.99
559,60,-5.9,174,72747,0.99
560,25,-2.4,171,72918,0.99
561,28,-2.7,172,73090,0.99
562,19,-1.8,172,73262,0.99
563,22,-2.1,179,73441,0.99
564,90,-8.9,177,73618,0.99
565,25,-2.4,172,73790,0.99
566,27,-2.6,176,73966,0.99
567,27,-2.6,182,74148,0.99
568,22,-2.1,180,74328,0.99
569,21,-2,179,74507,0.99
570,23,-2.2,176,74683,0.99
571,22,-2.1,177,74860,0.99
572,30,-2.9,173,75033,0.99
573,25,-2.4,176,75209,0.99
574,24,-2.3,182,75391,0.99
575,41,-4,171,75562,0.99
576,94,-9.3,177,75739,0.99
577,43,-4.2,178,75917,0.99
578,31,-3,176,76093,0.99
579,55,-5.4,181,76274,0.99
580,29,-2.8,184,76458,0.99
581,42,-4.1,178,76636,0.99
582,74,-7.3,178,76814,0.99
583,79,-7.8,177,76991,0.99
584,23,-2.2,179,77170,0.99
585,24,-2.3,179,77349,0.99
586,38,-3.7,179,77528,0.99
587,27,-2.6,177,77705,0.99
588,100,-9.9,178,77883,0.99
589,34,-3.3,177,78060,0.99
590,51,-5,176,78236,0.99
591,35,-3.4,183,78419,0.99
592,22,-2.1,178,78597,0.99
593,25,-2.4,179,78776,0.99
594,24,-2.3,176,78952,0.99
595,23,-2.2,179,79131,0.99
596,35,-3.4,186,79317,0.99
597,22,-2.1,180,79497,0.99
598,52,-5.1,181,79678,0.99
599,26,-2.5,178,79856,0.99
600,30,-2.9,177,80033,0.99
601,33,-3.2,177,80210,0.99
602,38,-3.7,183,80393,0.99
603,36,-3.5,178,80571,0.99
604,52,-5.1,181,80752,0.99
605,24,-2.3,177,80929,0.99
606,31,-3,177,81106,0.99
607,28,-2.7,184,81290,0.99
608,24,-2.3,176,81466,0.99
609,24,-2.3,177,81643,0.99
610,48,-4.7,179,81822,0.99
611,27,-2.6,180,82002,0.99
612,31,-3,180,82182,0.99
613,28,-2.7,186,82368,0.99
614,28,-2.7,181,82549,0.99
615,34,-3.3,180,82729,0.99
616,67,-6.6,181,82910,0.99
617,27,-2.6,178,83088,0.99
618,26,-2.5,186,83274,0.99
619,96,-9.5,179,83453,0.99
620,25,-2.4,178,83631,0.99
621,29,-2.8,178,83809,0.99
622,26,-2.5,183,83992,0.99
623,21,-2,177,84169,0.99
624,29,-2.8,184,84353,0.99
625,28,-2.7,183,84536,0.99
626,33,-3.2,183,84719,0.99
627,22,-2.1,183,84902,0.99
628,42,-4.1,183,85085,0.99
629,25,-2.4,181,85266,0.99
630,51,-5,180,85446,0.99
631,40,-3.9,183,85629,0.99
632,24,-2.3,180,85809,0.99
633,27,-2.6,184,85993,0.99
634,30,-2.9,182,86175,0.99
635,99,-9.8,188,86363,0.99
636,44,-4.3,181,86544,0.99
637,28,-2.7,183,86727,0.99
638,29,-2.8,185,86912,0.99
639,39,-3.8,184,87096,0.99
640,28,-2.7,187,87283,0.99
641,26,-2.5,178,87461,0.99
642,24,-2.3,183,87644,0.99
643,30,-2.9,181,87825,0.99
644,43,-4.2,182,88007,0.99
645,49,-4.8,181,88188,0.99
646,26,-2.5,186,88374,0.99
647,97,-9.6,181,88555,0.99
648,28,-2.7,182,88737,0.99
649,29,-2.8,184,88921,0.99
650,29,-2.8,184,89105,0.99
651,23,-2.2,187,89292,0.99
652,26,-2.5,183,89475,0.99
653,23,-2.2,185,89660,0.99
654,26,-2.5,183,89843,0.99
655,27,-2.6,183,90026,0.99
656,33,-3.2,189,90215,0.99
657,23,-2.2,194,90409,0.99
658,43,-4.2,182,90591,0.99
659,33,-3.2,188,90779,0.99
660,31,-3,187,90966,0.99
661,29,-2.8,183,91149,0.99
662,22,-2.1,192,91341,0.99
663,51,-5,183,91524,0.99
664,34,-3.3,186,91710,0.99
665,22,-2.1,185,91895,0.99
666,37,-3.6,186,92081,0.99
667,27,-2.6,191,92272,0.99
668,22,-2.1,185,92457,0.99
669,39,-3.8,184,92641,0.99
670,26,-2.5,189,92830,0.99
671,50,-4.9,183,93013,0.99
672,52,-5.1,188,93201,0.99
673,24,-2.3,189,93390,0.99
674,25,-2.4,187,93577,0.99
675,23,-2.2,183,93760,0.99
676,35,-3.4,185,93945,0.99
677,30,-2.9,184,94129,0.99
678,30,-2.9,189,94318,0.99
679,24,-2.3,188,94506,0.99
680,32,-3.1,188,94694,0.99
681,25,-2.4,187,94881,0.99
682,29,-2.8,186,95067,0.99
683,29,-2.8,189,95256,0.99
684,23,-2.2,189,95445,0.99
685,23,-2.2,183,95628,0.99
686,26,-2.5,187,95815,0.99
687,26,-2.5,188,96003,0.99
688,25,-2.4,189,96192,0.99
689,23,-2.2,194,96386,0.99
690,22,-2.1,184,96570,0.99
691,23,-2.2,190,96760,0.99
692,36,-3.5,186,96946,0.99
693,32,-3.1,188,97134,0.99
694,24,-2.3,193,97327,0.99
695,54,-5.3,190,97517,0.99
696,32,-3.1,189,97706,0.99
697,22,-2.1,187,97893,0.99
698,21,-2,195,98088,0.99
699,21,-2,195,98283,0.99
700,23,-2.2,187,98470,0.99
701,31,-3,185,98655,0.99
702,31,-3,187,98842,0.99
703,75,-7.4,190,99032,0.99
704,24,-2.3,189,99221,0.99
705,44,-4.3,194,99415,0.99
706,24,-2.3,192,99607,0.99
707,30,-2.9,189,99796,0.99
708,37,-3.6,188,99984,0.99
709,36,-3.5,188,100172,0.99
710,41,-4,195,100367,0.99
711,24,-2.3,191,100558,0.99
712,31,-3,189,100747,0.99
713,24,-2.3,191,100938,0.99
714,20,-1.9,190,101128,0.99
715,30,-2.9,193,101321,0.99
716,31,-3,188,101509,0.99
717,27,-2.6,191,101700,0.99
718,40,-3.9,192,101892,0.99
719,21,-2,190,102082,0.99
720,24,-2.3,195,102277,0.99
721,24,-2.3,191,102468,0.99
722,21,-2,192,102660,0.99
723,25,-2.4,189,102849,0.99
724,28,-2.7,189,103038,0.99
725,21,-2,191,103229,0.99
726,28,-2.7,188,103417,0.99
727,39,-3.8,189,103606,0.99
728,26,-2.5,191,103797,0.99
729,26,-2.5,188,103985,0.99
730,68,-6.7,194,104179,0.99
731,28,-2.7,195,104374,0.99
732,19,-1.8,188,104562,0.99
733,23,-2.2,191,104753,0.99
734,36,-3.5,190,104943,0.99
735,22,-2.1,190,105133,0.99
736,42,-4.1,201,105334,0.99
737,54,-5.3,191,105525,0.99
738,32,-3.1,193,105718,0.99
739,35,-3.4,188,105906,0.99
740,23,-2.2,190,106096,0.99
741,28,-2.7,198,106294,0.99
742,92,-9.1,192,106486,0.99
743,24,-2.3,191,106677,0.99
744,29,-2.8,193,106870,0.99
745,22,-2.1,191,107061,0.99
746,100,-9.9,199,107260,0.99
747,26,-2.5,195,107455,0.99
748,28,-2.7,191,107646,0.99
749,27,-2.6,192,107838,0.99
750,21,-2,191,108029,0.99
751,20,-1.9,203,108232,0.99
752,27,-2.6,195,108427,0.99
753,96,-9.5,193,108620,0.99
754,29,-2.8,193,108813,0.99
755,22,-2.1,194,109007,0.99
756,37,-3.6,197,109204,0.99
757,25,-2.4,193,109397,0.99
758,29,-2.8,194,109591,0.99
759,31,-3,191,109782,0.99
760,55,-5.4,195,109977,0.99
761,26,-2.5,194,110171,0.99
762,47,-4.6,201,110372,0.99
763,57,-5.6,192,110564,0.99
764,22,-2.1,193,110757,0.99
765,23,-2.2,192,110949,0.99
766,45,-4.4,194,111143,0.99
767,30,-2.9,197,111340,0.99
768,25,-2.4,194,111534,0.99
769,35,-3.4,196,111730,0.99
770,23,-2.2,194,111924,0.99
771,26,-2.5,198,112122,0.99
772,25,-2.4,198,112320,0.99
773,23,-2.2,191,112511,0.99
774,25,-2.4,197,112708,0.99
775,26,-2.5,193,112901,0.99
776,30,-2.9,200,113101,0.99
777,23,-2.2,198,113299,0.99
778,20,-1.9,194,113493,0.99
779,34,-3.3,192,113685,0.99
780,25,-2.4,200,113885,0.99
781,24,-2.3,195,114080,0.99
782,27,-2.6,200,114280,0.99
783,68,-6.7,198,114478,0.99
784,27,-2.6,198,114676,0.99
785,28,-2.7,197,114873,0.99
786,22,-2.1,199,115072,0.99
787,22,-2.1,206,115278,0.99
788,30,-2.9,194,115472,0.99
789,44,-4.3,199,115671,0.99
790,24,-2.3,202,115873,0.99
791,26,-2.5,201,116074,0.99
792,24,-2.3,203,116277,0.99
793,28,-2.7,197,116474,0.99
794,65,-6.4,197,116671,0.99
795,25,-2.4,198,116869,0.99
796,28,-2.7,199,117068,0.99
797,22,-2.1,203,117271,0.99
798,80,-7.9,198,117469,0.99
799,35,-3.4,197,117666,0.99
800,24,-2.3,194,117860,0.99
801,22,-2.1,200,118060,0.99
802,24,-2.3,200,118260,0.99
803,43,-4.2,195,118455,0.99
804,26,-2.5,197,118652,0.99
805,25,-2.4,201,118853,0.99
806,35,-3.4,198,119051,0.99
807,36,-3.5,202,119253,0.99
808,24,-2.3,196,119449,0.99
809,58,-5.7,197,119646,0.99
810,25,-2.4,196,119842,0.99
811,29,-2.8,198,120040,0.99
812,24,-2.3,209,120249,0.99
813,26,-2.5,194,120443,0.99
814,25,-2.4,197,120640,0.99
815,24,-2.3,201,120841,0.99
816,20,-1.9,198,121039,0.99
817,22,-2.1,205,121244,0.99
818,26,-2.5,200,121444,0.99
819,47,-4.6,201,121645,0.99
820,23,-2.2,199,121844,0.99
821,32,-3.1,196,122040,0.99
822,19,-1.8,205,122245,0.99
823,24,-2.3,197,122442,0.99
824,23,-2.2,194,122636,0.99
825,27,-2.6,198,122834,0.99
826,26,-2.5,200,123034,0.99
827,74,-7.3,202,123236,0.99
828,27,-2.6,201,123437,0.99
829,20,-1.9,199,123636,0.99
830,28,-2.7,200,123836,0.99
831,37,-3.6,198,124034,0.99
832,20,-1.9,203,124237,0.99
833,25,-2.4,198,124435,0.99
834,20,-1.9,197,124632,0.99
835,22,-2.1,205,124837,0.99
836,26,-2.5,201,125038,0.99
837,22,-2.1,206,125244,0.99
838,23,-2.2,196,125440,0.99
839,30,-2.9,205,125645,0.99
840,27,-2.6,201,125846,0.99
841,26,-2.5,201,126047,0.99
842,22,-2.1,206,126253,0.99
843,33,-3.2,199,126452,0.99
844,21,-2,201,126653,0.99
845,20,-1.9,202,126855,0.99
846,27,-2.6,200,127055,0.99
847,21,-2,208,127263,0.99
848,27,-2.6,204,127467,0.99
849,23,-2.2,201,127668,0.99
850,52,-5.1,201,127869,0.99
851,33,-3.2,203,128072,0.99
852,20,-1.9,210,128282,0.99
853,29,-2.8,200,128482,0.99
854,25,-2.4,201,128683,0.99
855,26,-2.5,203,128886,0.99
856,25,-2.4,201,129087,0.99
857,22,-2.1,201,129288,0.99
858,21,-2,202,129490,0.99
859,25,-2.4,201,129691,0.99
860,23,-2.2,205,129896,0.99
861,20,-1.9,200,130096,0.99
862,25,-2.4,210,130306,0.99
863,29,-2.8,201,130507,0.99
864,22,-2.1,205,130712,0.99
865,27,-2.6,205,130917,0.99
866,34,-3.3,203,131120,0.99
867,28,-2.7,207,131327,0.99
868,23,-2.2,200,131527,0.99
869,27,-2.6,200,131727,0.99
870,28,-2.7,201,131928,0.99
871,31,-3,204,132132,0.99
872,30,-2.9,209,132341,0.99
873,27,-2.6,204,132545,0.99
874,25,-2.4,204,132749,0.99
875,21,-2,204,132953,0.99
876,45,-4.4,204,133157,0.99
877,72,-7.1,200,133357,0.99
878,23,-2.2,200,133557,0.99
879,23,-2.2,205,133762,0.99
880,22,-2.1,202,133964,0.99
881,25,-2.4,209,134173,0.99
882,24,-2.3,202,134375,0.99
883,30,-2.9,203,134578,0.99
884,26,-2.5,204,134782,0.99
885,26,-2.5,205,134987,0.99
886,22,-2.1,211,135198,0.99
887,23,-2.2,206,135404,0.99
888,29,-2.8,206,135610,0.99
889,23,-2.2,209,135819,0.99
890,28,-2.7,205,136024,0.99
891,20,-1.9,214,136238,0.99
892,36,-3.5,204,136442,0.99
893,38,-3.7,207,136649,0.99
894,24,-2.3,206,136855,0.99
895,25,-2.4,203,137058,0.99
896,34,-3.3,211,137269,0.99
897,32,-3.1,203,137472,0.99
898,28,-2.7,202,137674,0.99
899,47,-4.6,206,137880,0.99
900,24,-2.3,206,138086,0.99
901,25,-2.4,211,138297,0.99
902,23,-2.2,207,138504,0.99
903,20,-1.9,204,138708,0.99
904,22,-2.1,204,138912,0.99
905,22,-2.1,208,139120,0.99
906,25,-2.4,207,139327,0.99
907,21,-2,203,139530,0.99
908,30,-2.9,209,139739,0.99
909,28,-2.7,206,139945,0.99
910,25,-2.4,212,140157,0.99
911,21,-2,209,140366,0.99
912,21,-2,217,140583,0.99
913,26,-2.5,208,140791,0.99
914,27,-2.6,208,140999,0.99
915,21,-2,211,141210,0.99
916,56,-5.5,204,141414,0.99
917,25,-2.4,208,141622,0.99
918,25,-2.4,213,141835,0.99
919,25,-2.4,210,142045,0.99
920,28,-2.7,214,142259,0.99
921,25,-2.4,206,142465,0.99
922,32,-3.1,210,142675,0.99
923,25,-2.4,210,142885,0.99
924,31,-3,207,143092,0.99
925,35,-3.4,214,143306,0.99
926,23,-2.2,207,143513,0.99
927,29,-2.8,212,143725,0.99
928,25,-2.4,206,143931,0.99
929,23,-2.2,210,144141,0.99
930,100,-9.9,209,144350,0.99
931,31,-3,208,144558,0.99
932,25,-2.4,208,144766,0.99
933,29,-2.8,206,144972,0.99
934,23,-2.2,213,145185,0.99
935,26,-2.5,206,145391,0.99
936,28,-2.7,206,145597,0.99
937,32,-3.1,211,145808,0.99
938,23,-2.2,208,146016,0.99
939,23,-2.2,215,146231,0.99
940,43,-4.2,208,146439,0.99
941,30,-2.9,209,146648,0.99
942,20,-1.9,208,146856,0.99
943,23,-2.2,213,147069,0.99
944,27,-2.6,215,147284,0.99
945,37,-3.6,209,147493,0.99
946,22,-2.1,210,147703,0.99
947,27,-2.6,211,147914,0.99
948,28,-2.7,214,148128,0.99
949,22,-2.1,210,148338,0.99
950,28,-2.7,211,148549,0.99
951,24,-2.3,209,148758,0.99
952,24,-2.3,208,148966,0.99
953,22,-2.1,214,149180,0.99
954,25,-2.4,208,149388,0.99
955,32,-3.1,209,149597,0.99
956,35,-3.4,211,149808,0.99
957,24,-2.3,212,150020,0.99
958,28,-2.7,215,150235,0.99
959,29,-2.8,214,150449,0.99
960,42,-4.1,212,150661,0.99
961,26,-2.5,207,150868,0.99
962,35,-3.4,212,151080,0.99
963,25,-2.4,213,151293,0.99
964,26,-2.5,209,151502,0.99
965,27,-2.6,213,151715,0.99
966,28,-2.7,207,151922,0.99
967,25,-2.4,216,152138,0.99
968,33,-3.2,214,152352,0.99
969,27,-2.6,208,152560,0.99
970,26,-2.5,212,152772,0.99
971,25,-2.4,215,152987,0.99
972,21,-2,214,153201,0.99
973,19,-1.8,215,153416,0.99
974,24,-2.3,212,153628,0.99
975,31,-3,214,153842,0.99
976,29,-2.8,210,154052,0.99
977,28,-2.7,218,154270,0.99
978,22,-2.1,210,154480,0.99
979,21,-2,210,154690,0.99
980,22,-2.1,211,154901,0.99
981,23,-2.2,216,155117,0.99
982,23,-2.2,214,155331,0.99
983,27,-2.6,212,155543,0.99
984,21,-2,213,155756,0.99
985,32,-3.1,211,155967,0.99
986,28,-2.7,220,156187,0.99
987,29,-2.8,215,156402,0.99
988,25,-2.4,213,156615,0.99
989,24,-2.3,215,156830,0.99
990,25,-2.4,213,157043,0.99
991,27,-2.6,218,157261,0.99
992,34,-3.3,210,157471,0.99
993,28,-2.7,214,157685,0.99
994,24,-2.3,209,157894,0.99
995,24,-2.3,214,158108,0.99
996,32,-3.1,212,158320,0.99
997,21,-2,214,158534,0.99
998,21,-2,215,158749,0.99
999,27,-2.6,211,158960,0.99
1000,28,-2.7,219,159179,0.99
1001,23,-2.2,217,159396,0.99
1002,23,-2.2,215,159611,0.99
1003,59,-5.8,216,159827,0.99
1004,29,-2.8,216,160043,0.99
1005,26,-2.5,220,160263,0.99
1006,25,-2.4,212,160475,0.99
1007,25,-2.4,215,160690,0.99
1008,25,-2.4,216,160906,0.99
1009,34,-3.3,216,161122,0.99
1010,22,-2.1,216,161338,0.99
1011,22,-2.1,215,161553,0.99
1012,29,-2.8,217,161770,0.99
1013,26,-2.5,214,161984,0.99
1014,27,-2.6,221,162205,0.99
1015,32,-3.1,215,162420,0.99
1016,38,-3.7,213,162633,0.99
1017,35,-3.4,219,162852,0.99
1018,27,-2.6,218,163070,0.99
1019,28,-2.7,215,163285,0.99
1020,27,-2.6,218,163503,0.99
1021,23,-2.2,216,163719,0.99
1022,41,-4,211,163930,0.99
1023,30,-2.9,224,164154,0.99
1024,29,-2.8,217,164371,0.99
1025,61,-6,216,164587,0.99
1026,28,-2.7,215,164802,0.99
1027,26,-2.5,217,165019,0.99
1028,30,-2.9,221,165240,0.99
1029,19,-1.8,214,165454,0.99
1030,32,-3.1,215,165669,0.99
1031,24,-2.3,215,165884,0.99
1032,21,-2,225,166109,0.99
1033,35,-3.4,215,166324,0.99
1034,34,-3.3,218,166542,0.99
1035,29,-2.8,215,166757,0.99
1036,19,-1.8,225,166982,0.99
1037,30,-2.9,226,167208,0.99
1038,25,-2.4,217,167425,0.99
1039,24,-2.3,215,167640,0.99
1040,28,-2.7,223,167863,0.99
1041,27,-2.6,218,168081,0.99
1042,37,-3.6,222,168303,0.99
1043,25,-2.4,217,168520,0.99
1044,21,-2,218,168738,0.99
1045,27,-2.6,215,168953,0.99
1046,22,-2.1,225,169178,0.99
1047,25,-2.4,221,169399,0.99
1048,26,-2.5,219,169618,0.99
1049,25,-2.4,218,169836,0.99
1050,24,-2.3,217,170053,0.99
1051,26,-2.5,219,170272,0.99
1052,24,-2.3,221,170493,0.99
1053,20,-1.9,220,170713,0.99
1054,50,-4.9,220,170933,0.99
1055,22,-2.1,225,171158,0.99
1056,24,-2.3,220,171378,0.99
1057,23,-2.2,218,171596,0.99
1058,21,-2,219,171815,0.99
1059,24,-2.3,219,172034,0.99
1060,22,-2.1,227,172261,0.99
1061,26,-2.5,218,172479,0.99
1062,26,-2.5,225,172704,0.99
1063,28,-2.7,216,172920,0.99
1064,22,-2.1,226,173146,0.99
1065,22,-2.1,218,173364,0.99
1066,35,-3.4,219,173583,0.99
1067,37,-3.6,215,173798,0.99
1068,25,-2.4,221,174019,0.99
1069,19,-1.8,224,174243,0.99
1070,37,-3.6,218,174461,0.99
1071,22,-2.1,223,174684,0.99
1072,28,-2.7,225,174909,0.99
1073,28,-2.7,229,175138,0.99
1074,100,-9.9,224,175362,0.99
1075,33,-3.2,222,175584,0.99
1076,24,-2.3,225,175809,0.99
1077,26,-2.5,221,176030,0.99
1078,28,-2.7,225,176255,0.99
1079,27,-2.6,221,176476,0.99
1080,50,-4.9,223,176699,0.99
1081,32,-3.1,221,176920,0.99
1082,24,-2.3,225,177145,0.99
1083,22,-2.1,221,177366,0.99
1084,26,-2.5,222,177588,0.99
1085,28,-2.7,223,177811,0.99
1086,30,-2.9,224,178035,0.99
1087,24,-2.3,221,178256,0.99
1088,24,-2.3,222,178478,0.99
1089,25,-2.4,220,178698,0.99
1090,25,-2.4,223,178921,0.99
1091,22,-2.1,225,179146,0.99
1092,25,-2.4,223,179369,0.99
1093,27,-2.6,222,179591,0.99
1094,22,-2.1,222,179813,0.99
1095,24,-2.3,224,180037,0.99
1096,23,-2.2,221,180258,0.99
1097,24,-2.3,223,180481,0.99
1098,28,-2.7,223,180704,0.99
1099,36,-3.5,224,180928,0.99
1100,24,-2.3,226,181154,0.99
1101,29,-2.8,221,181375,0.99
1102,28,-2.7,221,181596,0.99
1103,27,-2.6,221,181817,0.99
1104,22,-2.1,226,182043,0.99
1105,33,-3.2,227,182270,0.99
1106,22,-2.1,220,182490,0.99
1107,50,-4.9,220,182710,0.99
1108,25,-2.4,220,182930,0.99
1109,29,-2.8,231,183161,0.99
1110,23,-2.2,226,183387,0.99
1111,30,-2.9,222,183609,0.99
1112,26,-2.5,220,183829,0.99
1113,23,-2.2,226,184055,0.99
1114,28,-2.7,224,184279,0.99
1115,22,-2.1,224,184503,0.99
1116,20,-1.9,226,184729,0.99
1117,25,-2.4,224,184953,0.99
1118,21,-2,227,185180,0.99
1119,19,-1.8,224,185404,0.99
1120,26,-2.5,222,185626,0.99
1121,22,-2.1,223,185849,0.99
1122,28,-2.7,232,186081,0.99
1123,20,-1.9,227,186308,0.99
1124,23,-2.2,225,186533,0.99
1125,19,-1.8,228,186761,0.99
1126,31,-3,226,186987,0.99
1127,28,-2.7,228,187215,0.99
1128,33,-3.2,223,187438,0.99
1129,25,-2.4,227,187665,0.99
1130,23,-2.2,225,187890,0.99
1131,21,-2,232,188122,0.99
1132,21,-2,224,188346,0.99
1133,25,-2.4,227,188573,0.99
1134,28,-2.7,224,188797,0.99
1135,33,-3.2,227,189024,0.99
1136,34,-3.3,228,189252,0.99
1137,26,-2.5,226,189478,0.99
1138,51,-5,225,189703,0.99
1139,31,-3,223,189926,0.99
1140,20,-1.9,233,190159,0.99
1141,34,-3.3,224,190383,0.99
1142,28,-2.7,226,190609,0.99
1143,25,-2.4,225,190834,0.99
1144,26,-2.5,232,191066,0.99
1145,36,-3.5,228,191294,0.99
1146,31,-3,226,191520,0.99
1147,25,-2.4,227,191747,0.99
1148,25,-2.4,227,191974,0.99
1149,24,-2.3,230,192204,0.99
1150,54,-5.3,227,192431,0.99
1151,24,-2.3,225,192656,0.99
1152,26,-2.5,225,192881,0.99
1153,26,-2.5,232,193113,0.99
1154,19,-1.8,228,193341,0.99
1155,27,-2.6,225,193566,0.99
1156,20,-1.9,227,193793,0.99
1157,23,-2.2,233,194026,0.99
1158,24,-2.3,228,194254,0.99
1159,26,-2.5,223,194477,0.99
1160,37,-3.6,227,194704,0.99
1161,24,-2.3,227,194931,0.99
1162,25,-2.4,232,195163,0.99
1163,19,-1.8,227,195390,0.99
1164,43,-4.2,226,195616,0.99
1165,24,-2.3,228,195844,0.99
1166,31,-3,233,196077,0.99
1167,23,-2.2,227,196304,0.99
1168,35,-3.4,227,196531,0.99
1169,20,-1.9,227,196758,0.99
1170,25,-2.4,234,196992,0.99
1171,23,-2.2,231,197223,0.99
1172,21,-2,227,197450,0.99
1173,100,-9.9,229,197679,0.99
1174,34,-3.3,230,197909,0.99
1175,39,-3.8,236,198145,0.99
1176,21,-2,230,198375,0.99
1177,24,-2.3,229,198604,0.99
1178,30,-2.9,228,198832,0.99
1179,20,-1.9,231,199063,0.99
1180,23,-2.2,230,199293,0.99
1181,22,-2.1,229,199522,0.99
1182,24,-2.3,229,199751,0.99
1183,22,-2.1,232,199983,0.99
1184,31,-3,229,200212,0.99
1185,27,-2.6,231,200443,0.99
1186,23,-2.2,229,200672,0.99
1187,27,-2.6,228,200900,0.99
1188,35,-3.4,234,201134,0.99
1189,25,-2.4,229,201363,0.99
1190,33,-3.2,234,201597,0.99
1191,30,-2.9,227,201824,0.99
1192,22,-2.1,233,202057,0.99
1193,20,-1.9,231,202288,0.99
1194,24,-2.3,229,202517,0.99
1195,28,-2.7,230,202747,0.99
1196,24,-2.3,233,202980,0.99
1197,34,-3.3,231,203211,0.99
1198,23,-2.2,230,203441,0.99
1199,20,-1.9,230,203671,0.99
1200,31,-3,230,203901,0.99
1201,25,-2.4,236,204137,0.99
1202,32,-3.1,231,204368,0.99
1203,32,-3.1,230,204598,0.99
1204,24,-2.3,230,204828,0.99
1205,37,-3.6,232,205060,0.99
1206,20,-1.9,232,205292,0.99
1207,28,-2.7,229,205521,0.99
1208,20,-1.9,230,205751,0.99
1209,27,-2.6,232,205983,0.99
1210,27,-2.6,231,206214,0.99
1211,26,-2.5,230,206444,0.99
1212,31,-3,233,206677,0.99
1213,23,-2.2,235,206912,0.99
1214,25,-2.4,237,207149,0.99
1215,35,-3.4,233,207382,0.99
1216,23,-2.2,236,207618,0.99
1217,28,-2.7,231,207849,0.99
1218,28,-2.7,235,208084,0.99
1219,24,-2.3,230,208314,0.99
1220,40,-3.9,231,208545,0.99
1221,23,-2.2,234,208779,0.99
1222,22,-2.1,235,209014,0.99
1223,37,-3.6,236,209250,0.99
1224,23,-2.2,231,209481,0.99
1225,29,-2.8,231,209712,0.99
1226,24,-2.3,234,209946,0.99
1227,24,-2.3,238,210184,0.99
1228,28,-2.7,232,210416,0.99
1229,28,-2.7,233,210649,0.99
1230,25,-2.4,234,210883,0.99
1231,19,-1.8,235,211118,0.99
1232,24,-2.3,235,211353,0.99
1233,27,-2.6,234,211587,0.99
1234,32,-3.1,231,211818,0.99
1235,23,-2.2,236,212054,0.99
1236,30,-2.9,234,212288,0.99
1237,88,-8.7,234,212522,0.99
1238,26,-2.5,234,212756,0.99
1239,22,-2.1,239,212995,0.99
1240,22,-2.1,238,213233,0.99
1241,20,-1.9,233,213466,0.99
1242,22,-2.1,234,213700,0.99
1243,26,-2.5,235,213935,0.99
1244,29,-2.8,238,214173,0.99
1245,34,-3.3,233,214406,0.99
1246,29,-2.8,233,214639,0.99
1247,30,-2.9,234,214873,0.99
1248,22,-2.1,240,215113,0.99
1249,22,-2.1,233,215346,0.99
1250,31,-3,234,215580,0.99
1251,21,-2,232,215812,0.99
1252,25,-2.4,235,216047,0.99
1253,28,-2.7,234,216281,0.99
1254,28,-2.7,233,216514,0.99
1255,20,-1.9,238,216752,0.99
1256,38,-3.7,236,216988,0.99
1257,30,-2.9,236,217224,0.99
1258,29,-2.8,236,217460,0.99
1259,24,-2.3,234,217694,0.99
1260,28,-2.7,236,217930,0.99
1261,27,-2.6,241,218171,0.99
1262,27,-2.6,236,218407,0.99
1263,21,-2,236,218643,0.99
1264,33,-3.2,236,218879,0.99
1265,39,-3.8,236,219115,0.99
1266,28,-2.7,237,219352,0.99
1267,35,-3.4,235,219587,0.99
1268,28,-2.7,234,219821,0.99
1269,19,-1.8,242,220063,0.99
1270,26,-2.5,235,220298,0.99
1271,23,-2.2,236,220534,0.99
1272,25,-2.4,236,220770,0.99
1273,25,-2.4,241,221011,0.99
1274,20,-1.9,236,221247,0.99
1275,22,-2.1,235,221482,0.99
1276,22,-2.1,236,221718,0.99
1277,26,-2.5,240,221958,0.99
1278,22,-2.1,238,222196,0.99
1279,33,-3.2,240,222436,0.99
1280,20,-1.9,239,222675,0.99
1281,26,-2.5,235,222910,0.99
1282,34,-3.3,245,223155,0.99
1283,19,-1.8,237,223392,0.99
1284,25,-2.4,240,223632,0.99
1285,46,-4.5,240,223872,0.99
1286,23,-2.2,242,224114,0.99
1287,100,-9.9,238,224352,0.99
1288,24,-2.3,237,224589,0.99
1289,22,-2.1,236,224825,0.99
1290,28,-2.7,243,225068,0.99
1291,27,-2.6,239,225307,0.99
1292,26,-2.5,238,225545,0.99
1293,29,-2.8,236,225781,0.99
1294,35,-3.4,242,226023,0.99
1295,25,-2.4,236,226259,0.99
1296,20,-1.9,240,226499,0.99
1297,24,-2.3,238,226737,0.99
1298,27,-2.6,246,226983,0.99
1299,23,-2.2,239,227222,0.99
1300,24,-2.3,235,227457,0.99
1301,26,-2.5,240,227697,0.99
1302,26,-2.5,245,227942,0.99
1303,62,-6.1,239,228181,0.99
1304,20,-1.9,241,228422,0.99
1305,22,-2.1,239,228661,0.99
1306,26,-2.5,241,228902,0.99
1307,34,-3.3,242,229144,0.99
1308,22,-2.1,236,229380,0.99
1309,25,-2.4,239,229619,0.99
1310,24,-2.3,239,229858,0.99
1311,28,-2.7,246,230104,0.99
1312,27,-2.6,237,230341,0.99
1313,25,-2.4,238,230579,0.99
1314,22,-2.1,242,230821,0.99
1315,28,-2.7,244,231065,0.99
1316,32,-3.1,245,231310,0.99
1317,29,-2.8,238,231548,0.99
1318,24,-2.3,240,231788,0.99
1319,23,-2.2,244,232032,0.99
1320,27,-2.6,240,232272,0.99
1321,43,-4.2,239,232511,0.99
1322,24,-2.3,239,232750,0.99
1323,27,-2.6,241,232991,0.99
1324,21,-2,243,233234,0.99
1325,33,-3.2,238,233472,0.99
1326,27,-2.6,241,233713,0.99
1327,28,-2.7,245,233958,0.99
1328,21,-2,239,234197,0.99
1329,20,-1.9,242,234439,0.99
1330,28,-2.7,248,234687,0.99
1331,26,-2.5,244,234931,0.99
1332,30,-2.9,245,235176,0.99
1333,21,-2,244,235420,0.99
1334,26,-2.5,247,235667,0.99
1335,22,-2.1,247,235914,0.99
1336,30,-2.9,241,236155,0.99
1337,27,-2.6,245,236400,0.99
1338,24,-2.3,249,236649,0.99
1339,25,-2.4,241,236890,0.99
1340,20,-1.9,243,237133,0.99
1341,29,-2.8,239,237372,0.99
1342,19,-1.8,243,237615,0.99
1343,28,-2.7,242,237857,0.99
1344,23,-2.2,243,238100,0.99
1345,39,-3.8,244,238344,0.99
1346,21,-2,246,238590,0.99
1347,24,-2.3,243,238833,0.99
1348,33,-3.2,246,239079,0.99
1349,24,-2.3,240,239319,0.99
1350,26,-2.5,248,239567,0.99
1351,30,-2.9,246,239813,0.99
1352,24,-2.3,247,240060,0.99
1353,23,-2.2,243,240303,0.99
1354,20,-1.9,241,240544,0.99
1355,30,-2.9,247,240791,0.99
1356,24,-2.3,251,241042,0.99
1357,21,-2,242,241284,0.99
1358,29,-2.8,242,241526,0.99
1359,28,-2.7,245,241771,0.99
1360,20,-1.9,252,242023,0.99
1361,26,-2.5,241,242264,0.99
1362,35,-3.4,239,242503,0.99
1363,27,-2.6,243,242746,0.99
1364,43,-4.2,244,242990,0.99
1365,25,-2.4,239,243229,0.99
1366,100,-9.9,240,243469,0.99
1367,28,-2.7,243,243712,0.99
1368,25,-2.4,246,243958,0.99
1369,23,-2.2,247,244205,0.99
1370,31,-3,245,244450,0.99
1371,30,-2.9,247,244697,0.99
1372,20,-1.9,250,244947,0.99
1373,25,-2.4,248,245195,0.99
1374,20,-1.9,244,245439,0.99
1375,34,-3.3,244,245683,0.99
1376,34,-3.3,250,245933,0.99
1377,21,-2,246,246179,0.99
1378,28,-2.7,242,246421,0.99
1379,29,-2.8,246,246667,0.99
1380,19,-1.8,249,246916,0.99
1381,25,-2.4,244,247160,0.99
1382,44,-4.3,247,247407,0.99
1383,29,-2.8,246,247653,0.99
1384,75,-7.4,252,247905,0.99
1385,24,-2.3,241,248146,0.99
1386,28,-2.7,245,248391,0.99
1387,26,-2.5,247,248638,0.99
1388,27,-2.6,249,248887,0.99
1389,27,-2.6,246,249133,0.99
1390,25,-2.4,252,249385,0.99
1391,27,-2.6,243,249628,0.99
1392,20,-1.9,249,249877,0.99
1393,26,-2.5,245,250122,0.99
1394,26,-2.5,246,250368,0.99
1395,24,-2.3,250,250618,0.99
1396,100,-9.9,248,250866,0.99
1397,23,-2.2,249,251115,0.99
1398,23,-2.2,246,251361,0.99
1399,25,-2.4,251,251612,0.99
1400,27,-2.6,249,251861,0.99
1401,29,-2.8,249,252110,0.99
1402,22,-2.1,245,252355,0.99
1403,26,-2.5,247,252602,0.99
1404,34,-3.3,243,252845,0.99
1405,31,-3,249,253094,0.99
1406,28,-2.7,245,253339,0.99
1407,24,-2.3,248,253587,0.99
1408,25,-2.4,250,253837,0.99
1409,41,-4,254,254091,0.99
1410,25,-2.4,247,254338,0.99
1411,31,-3,250,254588,0.99
1412,23,-2.2,250,254838,0.99
1413,25,-2.4,253,255091,0.99
1414,37,-3.6,245,255336,0.99
1415,24,-2.3,247,255583,0.99
1416,22,-2.1,251,255834,0.99
1417,25,-2.4,253,256087,0.99
1418,67,-6.6,248,256335,0.99
1419,25,-2.4,248,256583,0.99
1420,27,-2.6,252,256835,0.99
1421,30,-2.9,250,257085,0.99
1422,30,-2.9,246,257331,0.99
1423,31,-3,245,257576,0.99
1424,31,-3,251,257827,0.99
1425,32,-3.1,256,258083,0.99
1426,24,-2.3,249,258332,0.99
1427,29,-2.8,252,258584,0.99
1428,25,-2.4,250,258834,0.99
1429,29,-2.8,251,259085,0.99
1430,29,-2.8,250,259335,0.99
1431,23,-2.2,245,259580,0.99
1432,35,-3.4,251,259831,0.99
1433,28,-2.7,256,260087,0.99
1434,21,-2,251,260338,0.99
1435,33,-3.2,249,260587,0.99
1436,34,-3.3,248,260835,0.99
1437,37,-3.6,256,261091,0.99
1438,20,-1.9,249,261340,0.99
1439,26,-2.5,249,261589,0.99
1440,26,-2.5,252,261841,0.99
1441,27,-2.6,254,262095,0.99
1442,23,-2.2,253,262348,0.99
1443,27,-2.6,249,262597,0.99
1444,26,-2.5,255,262852,0.99
1445,23,-2.2,252,263104,0.99
1446,38,-3.7,251,263355,0.99
1447,27,-2.6,250,263605,0.99
1448,23,-2.2,257,263862,0.99
1449,27,-2.6,249,264111,0.99
1450,31,-3,253,264364,0.99
1451,23,-2.2,250,264614,0.99
1452,23,-2.2,255,264869,0.99
1453,21,-2,250,265119,0.99
1454,24,-2.3,254,265373,0.99
1455,24,-2.3,254,265627,0.99
1456,34,-3.3,256,265883,0.99
1457,19,-1.8,250,266133,0.99
1458,28,-2.7,254,266387,0.99
1459,24,-2.3,256,266643,0.99
1460,25,-2.4,262,266905,0.99
1461,25,-2.4,252,267157,0.99
1462,23,-2.2,253,267410,0.99
1463,26,-2.5,253,267663,0.99
1464,31,-3,254,267917,0.99
1465,42,-4.1,250,268167,0.99
1466,32,-3.1,255,268422,0.99
1467,22,-2.1,253,268675,0.99
1468,23,-2.2,255,268930,0.99
1469,32,-3.1,251,269181,0.99
1470,28,-2.7,254,269435,0.99
1471,24,-2.3,250,269685,0.99
1472,22,-2.1,260,269945,0.99
1473,25,-2.4,255,270200,0.99
1474,27,-2.6,250,270450,0.99
1475,26,-2.5,258,270708,0.99
1476,31,-3,257,270965,0.99
1477,24,-2.3,253,271218,0.99
1478,29,-2.8,255,271473,0.99
1479,21,-2,253,271726,0.99
1480,29,-2.8,263,271989,0.99
1481,31,-3,253,272242,0.99
1482,38,-3.7,255,272497,0.99
1483,21,-2,254,272751,0.99
1484,24,-2.3,258,273009,0.99
1485,23,-2.2,253,273262,0.99
1486,24,-2.3,254,273516,0.99
1487,21,-2,253,273769,0.99
1488,29,-2.8,262,274031,0.99
1489,27,-2.6,253,274284,0.99
1490,22,-2.1,252,274536,0.99
1491,25,-2.4,256,274792,0.99
1492,22,-2.1,260,275052,0.99
1493,20,-1.9,254,275306,0.99
1494,24,-2.3,254,275560,0.99
1495,21,-2,257,275817,0.99
1496,24,-2.3,261,276078,0.99
1497,23,-2.2,254,276332,0.99
1498,32,-3.1,258,276590,0.99
1499,28,-2.7,260,276850,0.99
1500,28,-2.7,254,277104,0.99
