1, 64, -13.599999999999994, 62, 62, 0.99
2, 64, -6.299999999999994, 11, 73, 0.99
3, 64, -6.299999999999994, 70, 143, 0.99
4, 64, -6.299999999999994, 14, 157, 0.99
5, 64, -6.299999999999994, 57, 214, 0.99
6, 64, -6.299999999999994, 27, 241, 0.99
7, 64, -6.299999999999994, 60, 301, 0.99
8, 64, -6.299999999999994, 69, 370, 0.99
9, 64, -6.299999999999994, 36, 406, 0.99
10, 64, -13.899999999999995, 26, 432, 0.99
11, 64, -6.299999999999994, 41, 473, 0.99
12, 64, -6.299999999999994, 61, 534, 0.99
13, 64, -6.299999999999994, 46, 580, 0.99
14, 64, -6.299999999999994, 54, 634, 0.99
15, 64, -6.299999999999994, 81, 715, 0.99
16, 64, -7.19999999999999, 76, 791, 0.99
17, 64, -8.099999999999994, 131, 922, 0.99
18, 64, -8.199999999999994, 82, 1004, 0.99
19, 64, -6.299999999999994, 43, 1047, 0.99
20, 64, -6.299999999999994, 104, 1151, 0.99
21, 64, -6.299999999999994, 40, 1191, 0.99
22, 64, -6.299999999999994, 83, 1274, 0.99
23, 64, -6.299999999999994, 157, 1431, 0.99
24, 64, -6.299999999999994, 145, 1576, 0.99
25, 64, -7.1999999999999895, 127, 1703, 0.99
26, 64, -6.299999999999994, 96, 1799, 0.99
27, 64, -6.299999999999994, 138, 1937, 0.99
28, 64, -7.199999999999992, 151, 2088, 0.99
29, 64, -7.199999999999994, 70, 2158, 0.99
30, 64, -6.299999999999994, 93, 2251, 0.99
31, 64, -6.299999999999994, 65, 2316, 0.99
32, 64, -6.299999999999994, 88, 2404, 0.99
33, 64, -6.299999999999994, 51, 2455, 0.99
34, 64, -6.299999999999994, 49, 2504, 0.99
35, 64, -6.299999999999994, 70, 2574, 0.99
36, 64, -6.299999999999994, 66, 2640, 0.99
37, 64, -6.299999999999994, 57, 2697, 0.99
38, 64, -6.299999999999994, 55, 2752, 0.99
39, 64, -6.299999999999994, 45, 2797, 0.99
40, 64, -6.299999999999994, 35, 2832, 0.99
41, 64, -6.299999999999994, 32, 2864, 0.99
42, 64, -6.299999999999994, 34, 2898, 0.99
43, 64, -6.299999999999994, 37, 2935, 0.99
44, 64, -6.299999999999994, 43, 2978, 0.99
45, 64, -6.299999999999994, 36, 3014, 0.99
46, 64, -10.099999999999994, 40, 3054, 0.99
47, 64, -6.299999999999994, 45, 3099, 0.99
48, 64, -6.299999999999994, 40, 3139, 0.99
49, 64, -6.299999999999994, 43, 3182, 0.99
50, 64, -17.900000000000006, 40, 3222, 0.99
51, 64, -7.199999999999994, 40, 3262, 0.99
52, 64, -11.699999999999994, 45, 3307, 0.99
53, 64, -6.299999999999994, 38, 3345, 0.99
54, 64, -27.900000000000006, 46, 3391, 0.99
55, 64, -6.299999999999994, 70, 3461, 0.99
56, 64, -6.299999999999994, 72, 3533, 0.99
57, 64, -6.299999999999994, 69, 3602, 0.99
58, 64, -6.299999999999994, 58, 3660, 0.99
59, 64, -6.299999999999994, 66, 3726, 0.99
60, 64, -6.299999999999994, 67, 3793, 0.99
61, 64, -6.299999999999994, 57, 3850, 0.99
62, 64, -6.299999999999994, 39, 3889, 0.99
63, 64, -6.299999999999994, 42, 3931, 0.99
64, 64, -8.199999999999987, 49, 3980, 0.99
65, 64, -6.299999999999994, 42, 4022, 0.99
66, 64, -8.199999999999994, 53, 4075, 0.99
67, 64, -6.299999999999994, 47, 4122, 0.99
68, 64, -7.199999999999994, 43, 4165, 0.99
69, 64, -6.299999999999994, 42, 4207, 0.99
70, 64, -6.299999999999994, 43, 4250, 0.99
71, 64, -6.299999999999994, 46, 4296, 0.99
72, 64, -6.299999999999994, 46, 4342, 0.99
73, 64, -6.299999999999994, 45, 4387, 0.99
74, 64, -6.299999999999994, 53, 4440, 0.99
75, 64, -9.099999999999994, 48, 4488, 0.99
76, 64, -6.299999999999994, 48, 4536, 0.99
77, 64, -6.299999999999994, 49, 4585, 0.99
78, 64, -6.299999999999994, 55, 4640, 0.99
79, 64, -6.299999999999994, 52, 4692, 0.99
80, 64, -10.999999999999995, 49, 4741, 0.99
81, 64, -8.199999999999994, 43, 4784, 0.99
82, 64, -6.299999999999994, 49, 4833, 0.99
83, 64, -6.299999999999994, 54, 4887, 0.99
84, 64, -6.299999999999994, 55, 4942, 0.99
85, 64, -6.299999999999994, 73, 5015, 0.99
86, 64, -6.299999999999994, 90, 5105, 0.99
87, 64, -6.299999999999994, 84, 5189, 0.99
88, 64, -6.299999999999994, 85, 5274, 0.99
89, 64, -6.299999999999994, 53, 5327, 0.99
90, 64, -6.299999999999994, 52, 5379, 0.99
91, 64, -13.499999999999996, 53, 5432, 0.99
92, 64, -6.299999999999994, 54, 5486, 0.99
93, 64, -6.299999999999994, 56, 5542, 0.99
94, 64, -7.199999999999992, 52, 5594, 0.99
95, 49, -8.4, 56, 5650, 0.99
96, 64, -22.599999999999994, 57, 5707, 0.99
97, 64, -6.299999999999994, 53, 5760, 0.99
98, 64, -6.299999999999994, 58, 5818, 0.99
99, 64, -8.999999999999993, 61, 5879, 0.99
100, 64, -6.299999999999994, 59, 5938, 0.99
101, 38, -3.700000000000002, 52, 5990, 0.99
102, 64, -6.299999999999994, 61, 6051, 0.99
103, 64, -12.899999999999986, 57, 6108, 0.99
104, 64, -15.299999999999997, 61, 6169, 0.99
105, 41, -4.899999999999998, 62, 6231, 0.99
106, 64, -7.199999999999994, 57, 6288, 0.99
107, 64, -6.299999999999994, 57, 6345, 0.99
108, 20, -1.9000000000000006, 59, 6404, 0.99
109, 64, -6.299999999999994, 54, 6458, 0.99
110, 64, -6.299999999999994, 64, 6522, 0.99
111, 64, -12.999999999999995, 54, 6576, 0.99
112, 25, -5.199999999999999, 56, 6632, 0.99
113, 64, -6.299999999999994, 58, 6690, 0.99
114, 64, -10.099999999999994, 60, 6750, 0.99
115, 64, -6.299999999999994, 57, 6807, 0.99
116, 64, -7.199999999999992, 63, 6870, 0.99
117, 64, -10.899999999999993, 65, 6935, 0.99
118, 64, -10.099999999999994, 68, 7003, 0.99
119, 64, -6.299999999999994, 61, 7064, 0.99
120, 64, -6.299999999999994, 66, 7130, 0.99
121, 64, -8.99999999999999, 60, 7190, 0.99
122, 64, -6.299999999999994, 59, 7249, 0.99
123, 64, -11.999999999999984, 55, 7304, 0.99
124, 64, -6.299999999999994, 64, 7368, 0.99
125, 64, -6.299999999999994, 59, 7427, 0.99
126, 23, -2.2000000000000006, 61, 7488, 0.99
127, 64, -12.099999999999987, 66, 7554, 0.99
128, 64, -8.199999999999994, 69, 7623, 0.99
129, 64, -6.299999999999994, 61, 7684, 0.99
130, 64, -8.099999999999994, 64, 7748, 0.99
131, 64, -6.299999999999994, 60, 7808, 0.99
132, 64, -6.299999999999994, 63, 7871, 0.99
133, 64, -6.299999999999994, 64, 7935, 0.99
134, 64, -6.299999999999994, 65, 8000, 0.99
135, 53, -5.1999999999999975, 68, 8068, 0.99
136, 64, -6.299999999999994, 64, 8132, 0.99
137, 64, -8.19999999999999, 69, 8201, 0.99
138, 64, -6.299999999999994, 69, 8270, 0.99
139, 50, -4.899999999999999, 63, 8333, 0.99
140, 64, -6.299999999999994, 71, 8404, 0.99
141, 64, -19.700000000000006, 63, 8467, 0.99
142, 25, -2.400000000000001, 67, 8534, 0.99
143, 40, -3.900000000000002, 74, 8608, 0.99
144, 64, -6.299999999999994, 70, 8678, 0.99
145, 64, -6.299999999999994, 64, 8742, 0.99
146, 64, -6.299999999999994, 63, 8805, 0.99
147, 64, -7.199999999999994, 70, 8875, 0.99
148, 64, -6.299999999999994, 78, 8953, 0.99
149, 64, -6.299999999999994, 62, 9015, 0.99
150, 64, -6.299999999999994, 65, 9080, 0.99
151, 64, -6.299999999999994, 65, 9145, 0.99
152, 64, -6.299999999999994, 64, 9209, 0.99
153, 42, -4.100000000000001, 68, 9277, 0.99
154, 44, -5.200000000000001, 67, 9344, 0.99
155, 64, -6.299999999999994, 68, 9412, 0.99
156, 19, -3.6000000000000005, 68, 9480, 0.99
157, 64, -6.299999999999994, 70, 9550, 0.99
158, 64, -7.199999999999994, 70, 9620, 0.99
159, 64, -12.599999999999993, 68, 9688, 0.99
160, 64, -6.299999999999994, 68, 9756, 0.99
161, 64, -9.099999999999994, 72, 9828, 0.99
162, 64, -6.299999999999994, 70, 9898, 0.99
163, 64, -6.299999999999994, 79, 9977, 0.99
164, 64, -6.299999999999994, 81, 10058, 0.99
165, 64, -6.299999999999994, 80, 10138, 0.99
166, 64, -7.199999999999994, 107, 10245, 0.99
167, 54, -7.0999999999999925, 77, 10322, 0.99
168, 50, -4.899999999999999, 86, 10408, 0.99
169, 64, -6.299999999999994, 66, 10474, 0.99
170, 47, -8.399999999999995, 84, 10558, 0.99
171, 64, -8.19999999999999, 77, 10635, 0.99
172, 34, -3.3000000000000016, 79, 10714, 0.99
173, 35, -3.4000000000000017, 74, 10788, 0.99
174, 64, -16.8, 81, 10869, 0.99
175, 64, -7.199999999999994, 80, 10949, 0.99
176, 35, -4.300000000000001, 68, 11017, 0.99
177, 64, -6.299999999999994, 70, 11087, 0.99
178, 41, -5.799999999999997, 71, 11158, 0.99
179, 22, -4.899999999999999, 75, 11233, 0.99
180, 64, -6.299999999999994, 74, 11307, 0.99
181, 64, -6.299999999999994, 76, 11383, 0.99
182, 64, -6.299999999999994, 74, 11457, 0.99
183, 64, -6.299999999999994, 77, 11534, 0.99
184, 64, -14.899999999999986, 81, 11615, 0.99
185, 64, -6.299999999999994, 81, 11696, 0.99
186, 18, -1.7000000000000004, 77, 11773, 0.99
187, 64, -6.299999999999994, 76, 11849, 0.99
188, 42, -4.100000000000001, 79, 11928, 0.99
189, 16, -2.4000000000000004, 74, 12002, 0.99
190, 46, -4.5, 74, 12076, 0.99
191, 64, -6.299999999999994, 79, 12155, 0.99
192, 64, -6.299999999999994, 77, 12232, 0.99
193, 64, -6.299999999999994, 80, 12312, 0.99
194, 64, -10.099999999999993, 80, 12392, 0.99
195, 64, -8.099999999999994, 78, 12470, 0.99
196, 29, -3.700000000000001, 71, 12541, 0.99
197, 51, -6.799999999999999, 77, 12618, 0.99
198, 39, -3.800000000000002, 79, 12697, 0.99
199, 64, -6.299999999999994, 79, 12776, 0.99
200, 23, -5.999999999999997, 74, 12850, 0.99
201, 33, -4.1000000000000005, 83, 12933, 0.99
202, 57, -6.4999999999999964, 81, 13014, 0.99
203, 53, -8.999999999999991, 72, 13086, 0.99
204, 64, -6.299999999999994, 75, 13161, 0.99
205, 64, -6.299999999999994, 80, 13241, 0.99
206, 64, -6.299999999999994, 78, 13319, 0.99
207, 59, -6.699999999999996, 79, 13398, 0.99
208, 64, -6.299999999999994, 81, 13479, 0.99
209, 55, -8.09999999999999, 73, 13552, 0.99
210, 41, -4.000000000000002, 82, 13634, 0.99
211, 64, -6.299999999999994, 76, 13710, 0.99
212, 30, -2.9000000000000012, 76, 13786, 0.99
213, 20, -1.9000000000000006, 81, 13867, 0.99
214, 17, -2.5, 82, 13949, 0.99
215, 38, -5.599999999999997, 80, 14029, 0.99
216, 21, -2.0000000000000004, 76, 14105, 0.99
217, 64, -6.299999999999994, 82, 14187, 0.99
218, 34, -4.200000000000001, 87, 14274, 0.99
219, 25, -2.400000000000001, 77, 14351, 0.99
220, 64, -6.299999999999994, 85, 14436, 0.99
221, 30, -5.699999999999998, 90, 14526, 0.99
222, 17, -1.6000000000000003, 82, 14608, 0.99
223, 26, -6.199999999999999, 84, 14692, 0.99
224, 64, -10.999999999999988, 79, 14771, 0.99
225, 64, -6.299999999999994, 80, 14851, 0.99
226, 59, -6.699999999999996, 91, 14942, 0.99
227, 39, -5.699999999999995, 83, 15025, 0.99
228, 29, -2.800000000000001, 79, 15104, 0.99
229, 25, -3.300000000000001, 88, 15192, 0.99
230, 22, -2.1000000000000005, 80, 15272, 0.99
231, 64, -6.299999999999994, 81, 15353, 0.99
232, 64, -6.299999999999994, 78, 15431, 0.99
233, 23, -5.0, 81, 15512, 0.99
234, 34, -3.3000000000000016, 83, 15595, 0.99
235, 64, -12.599999999999989, 75, 15670, 0.99
236, 53, -20.600000000000016, 88, 15758, 0.99
237, 20, -2.8000000000000007, 85, 15843, 0.99
238, 33, -9.599999999999996, 88, 15931, 0.99
239, 64, -6.299999999999994, 83, 16014, 0.99
240, 38, -3.700000000000002, 76, 16090, 0.99
241, 21, -2.0000000000000004, 82, 16172, 0.99
242, 44, -6.1, 81, 16253, 0.99
243, 64, -6.299999999999994, 85, 16338, 0.99
244, 35, -4.300000000000002, 90, 16428, 0.99
245, 18, -1.7000000000000004, 84, 16512, 0.99
246, 27, -6.199999999999999, 83, 16595, 0.99
247, 64, -8.099999999999994, 79, 16674, 0.99
248, 64, -8.199999999999994, 84, 16758, 0.99
249, 64, -10.999999999999982, 86, 16844, 0.99
250, 64, -10.099999999999987, 94, 16938, 0.99
251, 61, -8.899999999999995, 91, 17029, 0.99
252, 64, -6.299999999999994, 83, 17112, 0.99
253, 64, -14.799999999999986, 85, 17197, 0.99
254, 64, -8.199999999999994, 84, 17281, 0.99
255, 26, -2.500000000000001, 85, 17366, 0.99
256, 64, -14.499999999999988, 90, 17456, 0.99
257, 64, -7.199999999999994, 86, 17542, 0.99
258, 52, -9.79999999999999, 84, 17626, 0.99
259, 64, -6.299999999999994, 76, 17702, 0.99
260, 52, -5.999999999999998, 83, 17785, 0.99
261, 26, -2.500000000000001, 86, 17871, 0.99
262, 64, -6.299999999999994, 84, 17955, 0.99
263, 37, -3.600000000000002, 85, 18040, 0.99
264, 27, -2.600000000000001, 83, 18123, 0.99
265, 36, -4.3999999999999995, 91, 18214, 0.99
266, 19, -1.8000000000000005, 87, 18301, 0.99
267, 55, -9.199999999999996, 82, 18383, 0.99
268, 64, -6.299999999999994, 87, 18470, 0.99
269, 41, -28.700000000000014, 86, 18556, 0.99
270, 33, -4.100000000000001, 85, 18641, 0.99
271, 20, -1.9000000000000006, 91, 18732, 0.99
272, 64, -8.099999999999987, 86, 18818, 0.99
273, 25, -3.3000000000000007, 90, 18908, 0.99
274, 17, -1.6000000000000003, 84, 18992, 0.99
275, 43, -4.200000000000001, 82, 19074, 0.99
276, 18, -1.7000000000000004, 93, 19167, 0.99
277, 22, -3.900000000000001, 86, 19253, 0.99
278, 44, -4.300000000000001, 81, 19334, 0.99
279, 18, -1.7000000000000004, 85, 19419, 0.99
280, 15, -1.4000000000000001, 87, 19506, 0.99
281, 18, -2.6000000000000005, 98, 19604, 0.99
282, 48, -4.699999999999999, 82, 19686, 0.99
283, 26, -2.500000000000001, 89, 19775, 0.99
284, 38, -5.599999999999995, 92, 19867, 0.99
285, 20, -4.799999999999997, 91, 19958, 0.99
286, 19, -1.8000000000000005, 83, 20041, 0.99
287, 45, -4.4, 89, 20130, 0.99
288, 64, -6.299999999999994, 86, 20216, 0.99
289, 18, -3.6000000000000005, 89, 20305, 0.99
290, 28, -4.5, 84, 20389, 0.99
291, 15, -1.4000000000000001, 94, 20483, 0.99
292, 48, -5.6, 88, 20571, 0.99
293, 22, -5.899999999999998, 88, 20659, 0.99
294, 35, -3.4000000000000017, 82, 20741, 0.99
295, 19, -1.8000000000000005, 98, 20839, 0.99
296, 17, -1.6000000000000003, 88, 20927, 0.99
297, 64, -6.299999999999994, 90, 21017, 0.99
298, 64, -25.20000000000001, 89, 21106, 0.99
299, 64, -6.299999999999994, 96, 21202, 0.99
300, 23, -2.2000000000000006, 86, 21288, 0.99
301, 44, -4.300000000000001, 93, 21381, 0.99
302, 19, -1.8000000000000005, 88, 21469, 0.99
303, 64, -14.39999999999999, 93, 21562, 0.99
304, 19, -4.6, 90, 21652, 0.99
305, 48, -6.599999999999998, 94, 21746, 0.99
306, 26, -2.500000000000001, 98, 21844, 0.99
307, 29, -4.6999999999999975, 94, 21938, 0.99
308, 16, -1.5000000000000002, 89, 22027, 0.99
309, 19, -1.8000000000000005, 87, 22114, 0.99
310, 21, -2.0000000000000004, 90, 22204, 0.99
311, 46, -4.5, 88, 22292, 0.99
312, 20, -2.8000000000000007, 92, 22384, 0.99
313, 24, -2.3000000000000007, 89, 22473, 0.99
314, 22, -2.1000000000000005, 95, 22568, 0.99
315, 16, -1.5000000000000002, 85, 22653, 0.99
316, 20, -1.9000000000000006, 92, 22745, 0.99
317, 23, -2.2000000000000006, 94, 22839, 0.99
318, 64, -51.900000000000034, 90, 22929, 0.99
319, 63, -9.999999999999995, 88, 23017, 0.99
320, 26, -2.500000000000001, 92, 23109, 0.99
321, 22, -4.000000000000001, 91, 23200, 0.99
322, 18, -1.7000000000000004, 84, 23284, 0.99
323, 35, -6.1, 88, 23372, 0.99
324, 22, -2.1000000000000005, 91, 23463, 0.99
325, 18, -1.7000000000000004, 93, 23556, 0.99
326, 35, -3.4000000000000017, 94, 23650, 0.99
327, 26, -3.400000000000001, 93, 23743, 0.99
328, 18, -1.7000000000000004, 105, 23848, 0.99
329, 33, -14.899999999999999, 88, 23936, 0.99
330, 28, -5.499999999999998, 90, 24026, 0.99
331, 16, -1.5000000000000002, 95, 24121, 0.99
332, 64, -8.199999999999994, 86, 24207, 0.99
333, 40, -3.900000000000002, 98, 24305, 0.99
334, 18, -1.7000000000000004, 91, 24396, 0.99
335, 35, -4.3, 98, 24494, 0.99
336, 22, -3.000000000000001, 93, 24587, 0.99
337, 16, -2.4000000000000004, 87, 24674, 0.99
338, 37, -3.600000000000002, 95, 24769, 0.99
339, 23, -2.2000000000000006, 100, 24869, 0.99
340, 47, -4.6, 106, 24975, 0.99
341, 23, -2.2000000000000006, 92, 25067, 0.99
342, 26, -2.500000000000001, 97, 25164, 0.99
343, 26, -2.500000000000001, 97, 25261, 0.99
344, 25, -2.400000000000001, 89, 25350, 0.99
345, 28, -2.700000000000001, 92, 25442, 0.99
346, 17, -1.6000000000000003, 93, 25535, 0.99
347, 64, -6.299999999999994, 99, 25634, 0.99
348, 27, -2.600000000000001, 100, 25734, 0.99
349, 19, -1.8000000000000005, 99, 25833, 0.99
350, 22, -2.1000000000000005, 95, 25928, 0.99
351, 45, -8.099999999999994, 97, 26025, 0.99
352, 19, -1.8000000000000005, 90, 26115, 0.99
353, 17, -1.6000000000000003, 92, 26207, 0.99
354, 22, -2.1000000000000005, 105, 26312, 0.99
355, 64, -17.700000000000003, 90, 26402, 0.99
356, 18, -1.7000000000000004, 96, 26498, 0.99
357, 19, -2.7, 90, 26588, 0.99
358, 18, -2.6000000000000005, 99, 26687, 0.99
359, 29, -2.800000000000001, 96, 26783, 0.99
360, 36, -5.3, 94, 26877, 0.99
361, 36, -3.5000000000000018, 96, 26973, 0.99
362, 18, -1.7000000000000004, 90, 27063, 0.99
363, 20, -1.9000000000000006, 96, 27159, 0.99
364, 28, -2.700000000000001, 93, 27252, 0.99
365, 33, -6.799999999999995, 95, 27347, 0.99
366, 64, -6.299999999999994, 93, 27440, 0.99
367, 64, -6.299999999999994, 96, 27536, 0.99
368, 17, -1.6000000000000003, 92, 27628, 0.99
369, 18, -1.7000000000000004, 99, 27727, 0.99
370, 21, -2.9000000000000004, 96, 27823, 0.99
371, 20, -1.9000000000000006, 95, 27918, 0.99
372, 17, -1.6000000000000003, 94, 28012, 0.99
373, 19, -2.7, 92, 28104, 0.99
374, 33, -4.1000000000000005, 102, 28206, 0.99
375, 20, -1.9000000000000006, 94, 28300, 0.99
376, 16, -1.5000000000000002, 93, 28393, 0.99
377, 20, -1.9000000000000006, 105, 28498, 0.99
378, 32, -3.1000000000000014, 95, 28593, 0.99
379, 35, -4.300000000000002, 92, 28685, 0.99
380, 24, -2.3000000000000007, 103, 28788, 0.99
381, 64, -6.299999999999994, 100, 28888, 0.99
382, 22, -4.000000000000001, 101, 28989, 0.99
383, 25, -3.300000000000001, 98, 29087, 0.99
384, 17, -1.6000000000000003, 91, 29178, 0.99
385, 39, -4.699999999999999, 107, 29285, 0.99
386, 60, -6.799999999999995, 94, 29379, 0.99
387, 25, -3.300000000000001, 96, 29475, 0.99
388, 44, -4.300000000000001, 97, 29572, 0.99
389, 35, -5.199999999999999, 99, 29671, 0.99
390, 40, -3.900000000000002, 101, 29772, 0.99
391, 16, -1.5000000000000002, 96, 29868, 0.99
392, 17, -1.6000000000000003, 96, 29964, 0.99
393, 18, -1.7000000000000004, 95, 30059, 0.99
394, 15, -2.3, 102, 30161, 0.99
395, 18, -1.7000000000000004, 101, 30262, 0.99
396, 32, -7.799999999999999, 102, 30364, 0.99
397, 17, -1.6000000000000003, 90, 30454, 0.99
398, 26, -2.500000000000001, 99, 30553, 0.99
399, 56, -5.4999999999999964, 97, 30650, 0.99
400, 27, -9.199999999999998, 100, 30750, 0.99
401, 15, -1.4000000000000001, 107, 30857, 0.99
402, 26, -2.500000000000001, 103, 30960, 0.99
403, 64, -6.299999999999994, 102, 31062, 0.99
404, 64, -7.199999999999994, 104, 31166, 0.99
405, 19, -1.8000000000000005, 104, 31270, 0.99
406, 30, -2.9000000000000012, 101, 31371, 0.99
407, 45, -4.4, 98, 31469, 0.99
408, 17, -1.6000000000000003, 99, 31568, 0.99
409, 17, -1.6000000000000003, 94, 31662, 0.99
410, 16, -1.5000000000000002, 103, 31765, 0.99
411, 22, -2.1000000000000005, 102, 31867, 0.99
412, 16, -2.4000000000000004, 100, 31967, 0.99
413, 33, -5.0, 92, 32059, 0.99
414, 21, -2.0000000000000004, 95, 32154, 0.99
415, 18, -1.7000000000000004, 96, 32250, 0.99
416, 17, -1.6000000000000003, 95, 32345, 0.99
417, 64, -24.300000000000026, 94, 32439, 0.99
418, 26, -3.400000000000001, 93, 32532, 0.99
419, 22, -3.000000000000001, 106, 32638, 0.99
420, 16, -1.5000000000000002, 98, 32736, 0.99
421, 20, -1.9000000000000006, 102, 32838, 0.99
422, 23, -2.2000000000000006, 109, 32947, 0.99
423, 15, -2.3, 101, 33048, 0.99
424, 64, -6.299999999999994, 101, 33149, 0.99
425, 64, -6.299999999999994, 105, 33254, 0.99
426, 26, -2.500000000000001, 108, 33362, 0.99
427, 20, -1.9000000000000006, 100, 33462, 0.99
428, 23, -2.2000000000000006, 104, 33566, 0.99
429, 18, -3.6000000000000005, 93, 33659, 0.99
430, 17, -1.6000000000000003, 95, 33754, 0.99
431, 17, -1.6000000000000003, 107, 33861, 0.99
432, 25, -2.400000000000001, 106, 33967, 0.99
433, 26, -2.500000000000001, 100, 34067, 0.99
434, 64, -6.299999999999994, 104, 34171, 0.99
435, 25, -2.400000000000001, 101, 34272, 0.99
436, 64, -30.80000000000002, 99, 34371, 0.99
437, 16, -2.4000000000000004, 104, 34475, 0.99
438, 17, -3.5000000000000004, 119, 34594, 0.99
439, 35, -4.300000000000001, 101, 34695, 0.99
440, 20, -1.9000000000000006, 103, 34798, 0.99
441, 62, -8.799999999999995, 98, 34896, 0.99
442, 64, -6.299999999999994, 104, 35000, 0.99
443, 35, -7.199999999999996, 99, 35099, 0.99
444, 24, -2.3000000000000007, 115, 35214, 0.99
445, 29, -3.700000000000001, 95, 35309, 0.99
446, 31, -3.9000000000000012, 100, 35409, 0.99
447, 32, -4.999999999999997, 102, 35511, 0.99
448, 32, -5.799999999999994, 106, 35617, 0.99
449, 15, -2.3, 107, 35724, 0.99
450, 17, -1.6000000000000003, 133, 35857, 0.99
451, 19, -2.7, 93, 35950, 0.99
452, 64, -6.299999999999994, 97, 36047, 0.99
453, 19, -2.7, 102, 36149, 0.99
454, 21, -2.0000000000000004, 108, 36257, 0.99
455, 23, -2.2000000000000006, 102, 36359, 0.99
456, 32, -3.1000000000000014, 109, 36468, 0.99
457, 21, -2.0000000000000004, 109, 36577, 0.99
458, 20, -1.9000000000000006, 121, 36698, 0.99
459, 33, -4.1000000000000005, 108, 36806, 0.99
460, 21, -2.0000000000000004, 100, 36906, 0.99
461, 15, -2.3, 100, 37006, 0.99
462, 20, -1.9000000000000006, 98, 37104, 0.99
463, 20, -1.9000000000000006, 99, 37203, 0.99
464, 49, -13.299999999999995, 108, 37311, 0.99
465, 18, -1.7000000000000004, 105, 37416, 0.99
466, 20, -2.8000000000000007, 105, 37521, 0.99
467, 21, -2.0000000000000004, 100, 37621, 0.99
468, 20, -2.8000000000000007, 104, 37725, 0.99
469, 19, -3.6000000000000005, 114, 37839, 0.99
470, 17, -1.6000000000000003, 102, 37941, 0.99
471, 41, -5.8, 101, 38042, 0.99
472, 16, -1.5000000000000002, 103, 38145, 0.99
473, 35, -4.300000000000001, 101, 38246, 0.99
474, 64, -6.299999999999994, 102, 38348, 0.99
475, 22, -2.1000000000000005, 108, 38456, 0.99
476, 21, -2.0000000000000004, 104, 38560, 0.99
477, 23, -2.2000000000000006, 129, 38689, 0.99
478, 31, -5.799999999999996, 143, 38832, 0.99
479, 22, -2.1000000000000005, 113, 38945, 0.99
480, 64, -8.199999999999994, 106, 39051, 0.99
481, 15, -1.4000000000000001, 106, 39157, 0.99
482, 18, -2.6000000000000005, 107, 39264, 0.99
483, 64, -6.299999999999994, 110, 39374, 0.99
484, 34, -5.199999999999996, 113, 39487, 0.99
485, 30, -2.9000000000000012, 99, 39586, 0.99
486, 18, -2.6000000000000005, 113, 39699, 0.99
487, 18, -1.7000000000000004, 105, 39804, 0.99
488, 16, -1.5000000000000002, 106, 39910, 0.99
489, 15, -1.4000000000000001, 102, 40012, 0.99
490, 15, -1.4000000000000001, 109, 40121, 0.99
491, 18, -1.7000000000000004, 112, 40233, 0.99
492, 17, -1.6000000000000003, 113, 40346, 0.99
493, 34, -5.199999999999997, 104, 40450, 0.99
494, 25, -2.400000000000001, 105, 40555, 0.99
495, 55, -10.099999999999994, 108, 40663, 0.99
496, 22, -2.1000000000000005, 114, 40777, 0.99
497, 21, -2.0000000000000004, 111, 40888, 0.99
498, 25, -3.3000000000000007, 105, 40993, 0.99
499, 31, -10.499999999999998, 107, 41100, 0.99
500, 20, -1.9000000000000006, 108, 41208, 0.99
501, 49, -5.699999999999999, 116, 41324, 0.99
502, 16, -1.5000000000000002, 108, 41432, 0.99
503, 22, -3.000000000000001, 104, 41536, 0.99
504, 25, -2.400000000000001, 109, 41645, 0.99
505, 47, -8.399999999999997, 121, 41766, 0.99
506, 18, -1.7000000000000004, 108, 41874, 0.99
507, 26, -3.400000000000001, 101, 41975, 0.99
508, 23, -2.2000000000000006, 111, 42086, 0.99
509, 18, -3.5, 103, 42189, 0.99
510, 22, -3.000000000000001, 105, 42294, 0.99
511, 19, -2.7, 107, 42401, 0.99
512, 35, -6.099999999999996, 111, 42512, 0.99
513, 17, -1.6000000000000003, 117, 42629, 0.99
514, 25, -2.400000000000001, 115, 42744, 0.99
515, 23, -2.2000000000000006, 122, 42866, 0.99
516, 23, -3.1000000000000005, 115, 42981, 0.99
517, 19, -1.8000000000000005, 110, 43091, 0.99
518, 22, -2.1000000000000005, 128, 43219, 0.99
519, 28, -3.600000000000001, 102, 43321, 0.99
520, 20, -1.9000000000000006, 107, 43428, 0.99
521, 22, -2.1000000000000005, 101, 43529, 0.99
522, 15, -1.4000000000000001, 109, 43638, 0.99
523, 17, -1.6000000000000003, 118, 43756, 0.99
524, 53, -5.1999999999999975, 114, 43870, 0.99
525, 44, -6.199999999999993, 114, 43984, 0.99
526, 40, -3.900000000000002, 115, 44099, 0.99
527, 20, -2.8000000000000007, 108, 44207, 0.99
528, 21, -2.0000000000000004, 116, 44323, 0.99
529, 26, -2.500000000000001, 109, 44432, 0.99
530, 64, -7.199999999999994, 109, 44541, 0.99
531, 22, -3.000000000000001, 104, 44645, 0.99
532, 21, -2.0000000000000004, 126, 44771, 0.99
533, 22, -2.1000000000000005, 124, 44895, 0.99
534, 17, -1.6000000000000003, 120, 45015, 0.99
535, 20, -1.9000000000000006, 107, 45122, 0.99
536, 19, -2.7, 110, 45232, 0.99
537, 18, -1.7000000000000004, 115, 45347, 0.99
538, 19, -1.8000000000000005, 111, 45458, 0.99
539, 19, -1.8000000000000005, 109, 45567, 0.99
540, 17, -1.6000000000000003, 110, 45677, 0.99
541, 16, -1.5000000000000002, 117, 45794, 0.99
542, 18, -1.7000000000000004, 110, 45904, 0.99
543, 18, -1.7000000000000004, 114, 46018, 0.99
544, 31, -3.0000000000000013, 109, 46127, 0.99
545, 24, -3.2000000000000006, 118, 46245, 0.99
546, 16, -1.5000000000000002, 114, 46359, 0.99
547, 18, -1.7000000000000004, 116, 46475, 0.99
548, 27, -5.399999999999999, 119, 46594, 0.99
549, 15, -1.4000000000000001, 120, 46714, 0.99
550, 20, -1.9000000000000006, 107, 46821, 0.99
551, 17, -2.5, 102, 46923, 0.99
552, 20, -1.9000000000000006, 118, 47041, 0.99
553, 26, -2.500000000000001, 111, 47152, 0.99
554, 22, -2.1000000000000005, 127, 47279, 0.99
555, 15, -1.4000000000000001, 110, 47389, 0.99
556, 17, -1.6000000000000003, 120, 47509, 0.99
557, 15, -1.4000000000000001, 112, 47621, 0.99
558, 27, -2.600000000000001, 119, 47740, 0.99
559, 20, -1.9000000000000006, 111, 47851, 0.99
560, 17, -1.6000000000000003, 111, 47962, 0.99
561, 19, -1.8000000000000005, 112, 48074, 0.99
562, 27, -3.500000000000001, 124, 48198, 0.99
563, 18, -1.7000000000000004, 110, 48308, 0.99
564, 18, -3.6000000000000005, 112, 48420, 0.99
565, 18, -1.7000000000000004, 121, 48541, 0.99
566, 29, -2.800000000000001, 115, 48656, 0.99
567, 19, -2.7, 122, 48778, 0.99
568, 20, -2.8000000000000007, 114, 48892, 0.99
569, 17, -1.6000000000000003, 116, 49008, 0.99
570, 19, -1.8000000000000005, 116, 49124, 0.99
571, 25, -2.400000000000001, 113, 49237, 0.99
572, 22, -5.899999999999997, 112, 49349, 0.99
573, 38, -3.700000000000002, 123, 49472, 0.99
574, 17, -1.6000000000000003, 109, 49581, 0.99
575, 25, -3.3000000000000007, 118, 49699, 0.99
576, 16, -1.5000000000000002, 117, 49816, 0.99
577, 39, -4.700000000000002, 112, 49928, 0.99
578, 29, -2.800000000000001, 116, 50044, 0.99
579, 29, -3.7000000000000015, 120, 50164, 0.99
580, 21, -2.9000000000000004, 135, 50299, 0.99
581, 24, -2.3000000000000007, 114, 50413, 0.99
582, 17, -1.6000000000000003, 113, 50526, 0.99
583, 64, -6.299999999999994, 116, 50642, 0.99
584, 17, -1.6000000000000003, 125, 50767, 0.99
585, 17, -1.6000000000000003, 116, 50883, 0.99
586, 18, -1.7000000000000004, 114, 50997, 0.99
587, 18, -3.6000000000000005, 121, 51118, 0.99
588, 18, -1.7000000000000004, 122, 51240, 0.99
589, 20, -1.9000000000000006, 119, 51359, 0.99
590, 64, -13.599999999999984, 114, 51473, 0.99
591, 26, -3.4000000000000012, 113, 51586, 0.99
592, 22, -4.0, 116, 51702, 0.99
593, 21, -2.0000000000000004, 121, 51823, 0.99
594, 49, -4.799999999999999, 111, 51934, 0.99
595, 24, -2.3000000000000007, 131, 52065, 0.99
596, 21, -2.9000000000000004, 128, 52193, 0.99
597, 26, -2.500000000000001, 132, 52325, 0.99
598, 19, -1.8000000000000005, 117, 52442, 0.99
599, 16, -1.5000000000000002, 117, 52559, 0.99
600, 39, -4.699999999999998, 123, 52682, 0.99
601, 22, -2.1000000000000005, 123, 52805, 0.99
602, 27, -2.600000000000001, 113, 52918, 0.99
603, 20, -1.9000000000000006, 118, 53036, 0.99
604, 25, -2.400000000000001, 122, 53158, 0.99
605, 39, -3.800000000000002, 116, 53274, 0.99
606, 26, -3.400000000000001, 118, 53392, 0.99
607, 27, -2.600000000000001, 115, 53507, 0.99
608, 17, -1.6000000000000003, 182, 53689, 0.99
609, 64, -6.299999999999994, 121, 53810, 0.99
610, 17, -1.6000000000000003, 115, 53925, 0.99
611, 17, -1.6000000000000003, 115, 54040, 0.99
612, 21, -2.0000000000000004, 112, 54152, 0.99
613, 21, -2.0000000000000004, 134, 54286, 0.99
614, 20, -1.9000000000000006, 115, 54401, 0.99
615, 17, -1.6000000000000003, 110, 54511, 0.99
616, 19, -1.8000000000000005, 120, 54631, 0.99
617, 22, -2.1000000000000005, 126, 54757, 0.99
618, 23, -2.2000000000000006, 116, 54873, 0.99
619, 22, -2.1000000000000005, 131, 55004, 0.99
620, 22, -2.1000000000000005, 111, 55115, 0.99
621, 19, -1.8000000000000005, 116, 55231, 0.99
622, 17, -1.6000000000000003, 127, 55358, 0.99
623, 23, -3.1000000000000005, 146, 55504, 0.99
624, 18, -2.6, 118, 55622, 0.99
625, 20, -1.9000000000000006, 123, 55745, 0.99
626, 20, -1.9000000000000006, 121, 55866, 0.99
627, 15, -1.4000000000000001, 123, 55989, 0.99
628, 23, -2.2000000000000006, 120, 56109, 0.99
629, 20, -1.9000000000000006, 113, 56222, 0.99
630, 24, -2.3000000000000007, 115, 56337, 0.99
631, 21, -2.0000000000000004, 118, 56455, 0.99
632, 26, -2.500000000000001, 122, 56577, 0.99
633, 22, -2.1000000000000005, 129, 56706, 0.99
634, 29, -2.800000000000001, 114, 56820, 0.99
635, 64, -6.299999999999994, 118, 56938, 0.99
636, 20, -1.9000000000000006, 122, 57060, 0.99
637, 18, -1.7000000000000004, 127, 57187, 0.99
638, 16, -1.5000000000000002, 116, 57303, 0.99
639, 36, -7.099999999999996, 117, 57420, 0.99
640, 22, -2.1000000000000005, 116, 57536, 0.99
641, 17, -1.6000000000000003, 123, 57659, 0.99
642, 29, -2.800000000000001, 116, 57775, 0.99
643, 22, -2.1000000000000005, 115, 57890, 0.99
644, 21, -2.0000000000000004, 123, 58013, 0.99
645, 26, -4.300000000000001, 118, 58131, 0.99
646, 64, -6.299999999999994, 123, 58254, 0.99
647, 21, -2.0000000000000004, 117, 58371, 0.99
648, 43, -7.999999999999991, 125, 58496, 0.99
649, 15, -1.4000000000000001, 142, 58638, 0.99
650, 25, -4.299999999999999, 123, 58761, 0.99
651, 21, -2.9000000000000004, 115, 58876, 0.99
652, 18, -1.7000000000000004, 114, 58990, 0.99
653, 21, -2.0000000000000004, 119, 59109, 0.99
654, 64, -6.299999999999994, 126, 59235, 0.99
655, 16, -1.5000000000000002, 123, 59358, 0.99
656, 25, -3.3000000000000007, 126, 59484, 0.99
657, 18, -2.6000000000000005, 120, 59604, 0.99
658, 23, -2.2000000000000006, 119, 59723, 0.99
659, 17, -1.6000000000000003, 114, 59837, 0.99
660, 21, -2.0000000000000004, 124, 59961, 0.99
661, 17, -2.5, 129, 60090, 0.99
662, 18, -1.7000000000000004, 130, 60220, 0.99
663, 26, -3.4000000000000012, 124, 60344, 0.99
664, 17, -1.6000000000000003, 126, 60470, 0.99
665, 26, -2.500000000000001, 126, 60596, 0.99
666, 21, -2.0000000000000004, 135, 60731, 0.99
667, 63, -8.099999999999994, 119, 60850, 0.99
668, 24, -2.3000000000000007, 122, 60972, 0.99
669, 15, -1.4000000000000001, 121, 61093, 0.99
670, 18, -2.6000000000000005, 125, 61218, 0.99
671, 20, -4.699999999999999, 122, 61340, 0.99
672, 64, -6.299999999999994, 126, 61466, 0.99
673, 17, -1.6000000000000003, 118, 61584, 0.99
674, 21, -2.9000000000000004, 129, 61713, 0.99
675, 24, -2.3000000000000007, 116, 61829, 0.99
676, 15, -1.4000000000000001, 119, 61948, 0.99
677, 33, -4.1000000000000005, 119, 62067, 0.99
678, 17, -2.5, 116, 62183, 0.99
679, 20, -2.8000000000000007, 121, 62304, 0.99
680, 22, -2.1000000000000005, 121, 62425, 0.99
681, 16, -2.4000000000000004, 127, 62552, 0.99
682, 15, -1.4000000000000001, 130, 62682, 0.99
683, 20, -2.8000000000000007, 120, 62802, 0.99
684, 22, -2.1000000000000005, 127, 62929, 0.99
685, 16, -1.5000000000000002, 119, 63048, 0.99
686, 20, -1.9000000000000006, 130, 63178, 0.99
687, 24, -4.2, 117, 63295, 0.99
688, 25, -3.3000000000000007, 128, 63423, 0.99
689, 18, -2.6000000000000005, 122, 63545, 0.99
690, 21, -2.0000000000000004, 133, 63678, 0.99
691, 20, -1.9000000000000006, 124, 63802, 0.99
692, 16, -1.5000000000000002, 121, 63923, 0.99
693, 23, -3.100000000000001, 120, 64043, 0.99
694, 17, -1.6000000000000003, 128, 64171, 0.99
695, 25, -2.400000000000001, 130, 64301, 0.99
696, 17, -1.6000000000000003, 126, 64427, 0.99
697, 22, -2.1000000000000005, 122, 64549, 0.99
698, 16, -1.5000000000000002, 138, 64687, 0.99
699, 15, -1.4000000000000001, 119, 64806, 0.99
700, 30, -2.9000000000000012, 140, 64946, 0.99
701, 26, -2.500000000000001, 127, 65073, 0.99
702, 21, -2.0000000000000004, 128, 65201, 0.99
703, 22, -2.1000000000000005, 127, 65328, 0.99
704, 20, -1.9000000000000006, 117, 65445, 0.99
705, 18, -1.7000000000000004, 123, 65568, 0.99
706, 30, -2.9000000000000012, 134, 65702, 0.99
707, 26, -3.400000000000001, 121, 65823, 0.99
708, 36, -9.099999999999998, 128, 65951, 0.99
709, 21, -2.0000000000000004, 120, 66071, 0.99
710, 16, -1.5000000000000002, 126, 66197, 0.99
711, 47, -7.399999999999997, 118, 66315, 0.99
712, 17, -2.5, 124, 66439, 0.99
713, 19, -1.8000000000000005, 134, 66573, 0.99
714, 21, -2.0000000000000004, 131, 66704, 0.99
715, 29, -2.800000000000001, 130, 66834, 0.99
716, 20, -1.9000000000000006, 129, 66963, 0.99
717, 18, -1.7000000000000004, 122, 67085, 0.99
718, 21, -2.0000000000000004, 126, 67211, 0.99
719, 32, -3.1000000000000014, 130, 67341, 0.99
720, 24, -4.1000000000000005, 122, 67463, 0.99
721, 17, -1.6000000000000003, 127, 67590, 0.99
722, 21, -2.0000000000000004, 144, 67734, 0.99
723, 57, -5.599999999999996, 129, 67863, 0.99
724, 17, -2.5, 129, 67992, 0.99
725, 18, -1.7000000000000004, 125, 68117, 0.99
726, 27, -2.600000000000001, 123, 68240, 0.99
727, 20, -2.8000000000000007, 127, 68367, 0.99
728, 17, -2.5, 133, 68500, 0.99
729, 48, -6.599999999999994, 143, 68643, 0.99
730, 40, -4.8000000000000025, 135, 68778, 0.99
731, 18, -1.7000000000000004, 131, 68909, 0.99
732, 21, -2.0000000000000004, 123, 69032, 0.99
733, 24, -2.3000000000000007, 136, 69168, 0.99
734, 26, -4.3, 142, 69310, 0.99
735, 18, -2.6000000000000005, 122, 69432, 0.99
736, 23, -2.2000000000000006, 133, 69565, 0.99
737, 23, -2.2000000000000006, 122, 69687, 0.99
738, 34, -4.200000000000001, 123, 69810, 0.99
739, 17, -2.5, 123, 69933, 0.99
740, 18, -1.7000000000000004, 124, 70057, 0.99
741, 19, -2.7, 130, 70187, 0.99
742, 27, -2.600000000000001, 139, 70326, 0.99
743, 16, -1.5000000000000002, 126, 70452, 0.99
744, 15, -1.4000000000000001, 127, 70579, 0.99
745, 16, -1.5000000000000002, 139, 70718, 0.99
746, 29, -2.800000000000001, 117, 70835, 0.99
747, 20, -2.8000000000000007, 127, 70962, 0.99
748, 15, -1.4000000000000001, 132, 71094, 0.99
749, 27, -2.600000000000001, 129, 71223, 0.99
750, 19, -2.7, 127, 71350, 0.99
751, 18, -1.7000000000000004, 129, 71479, 0.99
752, 19, -1.8000000000000005, 129, 71608, 0.99
753, 25, -2.400000000000001, 126, 71734, 0.99
754, 29, -3.700000000000001, 133, 71867, 0.99
755, 25, -4.199999999999999, 131, 71998, 0.99
756, 19, -2.7, 128, 72126, 0.99
757, 16, -2.4000000000000004, 129, 72255, 0.99
758, 32, -3.1000000000000014, 126, 72381, 0.99
759, 16, -1.5000000000000002, 128, 72509, 0.99
760, 21, -2.0000000000000004, 135, 72644, 0.99
761, 25, -3.3000000000000007, 131, 72775, 0.99
762, 15, -1.4000000000000001, 132, 72907, 0.99
763, 22, -2.1000000000000005, 132, 73039, 0.99
764, 22, -2.1000000000000005, 134, 73173, 0.99
765, 18, -2.6000000000000005, 137, 73310, 0.99
766, 20, -1.9000000000000006, 125, 73435, 0.99
767, 19, -1.8000000000000005, 131, 73566, 0.99
768, 16, -2.4000000000000004, 138, 73704, 0.99
769, 17, -1.6000000000000003, 129, 73833, 0.99
770, 21, -2.0000000000000004, 124, 73957, 0.99
771, 22, -2.1000000000000005, 140, 74097, 0.99
772, 27, -4.499999999999999, 130, 74227, 0.99
773, 24, -3.200000000000001, 137, 74364, 0.99
774, 22, -2.1000000000000005, 125, 74489, 0.99
775, 25, -2.400000000000001, 138, 74627, 0.99
776, 29, -3.700000000000001, 130, 74757, 0.99
777, 17, -1.6000000000000003, 124, 74881, 0.99
778, 16, -1.5000000000000002, 131, 75012, 0.99
779, 17, -3.5000000000000004, 132, 75144, 0.99
780, 21, -2.0000000000000004, 141, 75285, 0.99
781, 22, -2.1000000000000005, 137, 75422, 0.99
782, 16, -1.5000000000000002, 124, 75546, 0.99
783, 21, -2.0000000000000004, 132, 75678, 0.99
784, 18, -1.7000000000000004, 127, 75805, 0.99
785, 24, -4.1000000000000005, 139, 75944, 0.99
786, 17, -1.6000000000000003, 136, 76080, 0.99
787, 23, -4.1, 131, 76211, 0.99
788, 20, -3.8000000000000007, 159, 76370, 0.99
789, 27, -2.600000000000001, 126, 76496, 0.99
790, 23, -2.2000000000000006, 132, 76628, 0.99
791, 19, -1.8000000000000005, 123, 76751, 0.99
792, 64, -8.199999999999994, 124, 76875, 0.99
793, 25, -4.299999999999999, 126, 77001, 0.99
794, 19, -1.8000000000000005, 128, 77129, 0.99
795, 64, -6.299999999999994, 132, 77261, 0.99
796, 22, -2.1000000000000005, 130, 77391, 0.99
797, 45, -6.299999999999993, 129, 77520, 0.99
798, 48, -21.80000000000003, 133, 77653, 0.99
799, 24, -2.3000000000000007, 131, 77784, 0.99
800, 16, -1.5000000000000002, 130, 77914, 0.99
801, 26, -2.500000000000001, 127, 78041, 0.99
802, 23, -2.2000000000000006, 132, 78173, 0.99
803, 18, -2.6000000000000005, 127, 78300, 0.99
804, 23, -2.2000000000000006, 131, 78431, 0.99
805, 20, -1.9000000000000006, 136, 78567, 0.99
806, 17, -1.6000000000000003, 138, 78705, 0.99
807, 26, -7.099999999999999, 125, 78830, 0.99
808, 22, -5.899999999999998, 133, 78963, 0.99
809, 17, -1.6000000000000003, 134, 79097, 0.99
810, 17, -1.6000000000000003, 130, 79227, 0.99
811, 18, -1.7000000000000004, 129, 79356, 0.99
812, 23, -2.2000000000000006, 128, 79484, 0.99
813, 19, -1.8000000000000005, 136, 79620, 0.99
814, 18, -1.7000000000000004, 135, 79755, 0.99
815, 18, -3.6000000000000005, 127, 79882, 0.99
816, 25, -3.3000000000000007, 132, 80014, 0.99
817, 19, -1.8000000000000005, 131, 80145, 0.99
818, 54, -6.1999999999999975, 133, 80278, 0.99
819, 17, -2.5, 127, 80405, 0.99
820, 21, -2.0000000000000004, 130, 80535, 0.99
821, 33, -5.099999999999996, 141, 80676, 0.99
822, 17, -1.6000000000000003, 126, 80802, 0.99
823, 22, -3.000000000000001, 129, 80931, 0.99
824, 31, -4.899999999999997, 131, 81062, 0.99
825, 17, -1.6000000000000003, 135, 81197, 0.99
826, 17, -1.6000000000000003, 137, 81334, 0.99
827, 20, -5.499999999999999, 130, 81464, 0.99
828, 23, -2.2000000000000006, 138, 81602, 0.99
829, 22, -2.1000000000000005, 131, 81733, 0.99
830, 24, -3.200000000000001, 135, 81868, 0.99
831, 15, -1.4000000000000001, 123, 81991, 0.99
832, 21, -2.0000000000000004, 138, 82129, 0.99
833, 21, -2.0000000000000004, 132, 82261, 0.99
834, 64, -9.199999999999989, 134, 82395, 0.99
835, 19, -2.7, 141, 82536, 0.99
836, 22, -4.000000000000001, 146, 82682, 0.99
837, 19, -1.8000000000000005, 136, 82818, 0.99
838, 15, -1.4000000000000001, 134, 82952, 0.99
839, 18, -2.6000000000000005, 133, 83085, 0.99
840, 24, -2.3000000000000007, 126, 83211, 0.99
841, 20, -1.9000000000000006, 139, 83350, 0.99
842, 31, -3.0000000000000013, 135, 83485, 0.99
843, 39, -6.5999999999999925, 149, 83634, 0.99
844, 17, -1.6000000000000003, 131, 83765, 0.99
845, 18, -1.7000000000000004, 140, 83905, 0.99
846, 20, -3.8000000000000007, 138, 84043, 0.99
847, 16, -1.5000000000000002, 127, 84170, 0.99
848, 18, -1.7000000000000004, 132, 84302, 0.99
849, 22, -3.000000000000001, 135, 84437, 0.99
850, 21, -2.9000000000000004, 146, 84583, 0.99
851, 21, -2.9000000000000004, 135, 84718, 0.99
852, 19, -1.8000000000000005, 139, 84857, 0.99
853, 28, -4.599999999999999, 134, 84991, 0.99
854, 17, -1.6000000000000003, 142, 85133, 0.99
855, 29, -3.700000000000001, 132, 85265, 0.99
856, 20, -4.699999999999999, 132, 85397, 0.99
857, 20, -1.9000000000000006, 133, 85530, 0.99
858, 17, -1.6000000000000003, 136, 85666, 0.99
859, 20, -1.9000000000000006, 139, 85805, 0.99
860, 23, -4.1000000000000005, 135, 85940, 0.99
861, 20, -1.9000000000000006, 134, 86074, 0.99
862, 18, -1.7000000000000004, 134, 86208, 0.99
863, 35, -4.3, 139, 86347, 0.99
864, 25, -6.199999999999998, 126, 86473, 0.99
865, 25, -6.1999999999999975, 147, 86620, 0.99
866, 20, -1.9000000000000006, 140, 86760, 0.99
867, 19, -1.8000000000000005, 141, 86901, 0.99
868, 18, -1.7000000000000004, 133, 87034, 0.99
869, 31, -4.800000000000001, 135, 87169, 0.99
870, 54, -5.299999999999997, 136, 87305, 0.99
871, 26, -4.300000000000001, 136, 87441, 0.99
872, 21, -2.0000000000000004, 140, 87581, 0.99
873, 30, -5.6, 134, 87715, 0.99
874, 18, -1.7000000000000004, 144, 87859, 0.99
875, 17, -2.5, 145, 88004, 0.99
876, 17, -1.6000000000000003, 135, 88139, 0.99
877, 16, -1.5000000000000002, 142, 88281, 0.99
878, 25, -4.3, 129, 88410, 0.99
879, 19, -1.8000000000000005, 140, 88550, 0.99
880, 22, -2.1000000000000005, 136, 88686, 0.99
881, 17, -2.5, 134, 88820, 0.99
882, 15, -1.4000000000000001, 138, 88958, 0.99
883, 17, -1.6000000000000003, 137, 89095, 0.99
884, 18, -1.7000000000000004, 127, 89222, 0.99
885, 37, -5.3999999999999995, 142, 89364, 0.99
886, 50, -4.899999999999999, 136, 89500, 0.99
887, 22, -2.1000000000000005, 132, 89632, 0.99
888, 40, -4.800000000000001, 137, 89769, 0.99
889, 23, -2.2000000000000006, 129, 89898, 0.99
890, 19, -3.6000000000000005, 144, 90042, 0.99
891, 21, -2.0000000000000004, 140, 90182, 0.99
892, 19, -1.8000000000000005, 139, 90321, 0.99
893, 21, -2.0000000000000004, 134, 90455, 0.99
894, 18, -1.7000000000000004, 139, 90594, 0.99
895, 21, -5.799999999999998, 127, 90721, 0.99
896, 20, -2.8000000000000007, 143, 90864, 0.99
897, 30, -2.9000000000000012, 137, 91001, 0.99
898, 16, -1.5000000000000002, 137, 91138, 0.99
899, 19, -1.8000000000000005, 138, 91276, 0.99
900, 23, -2.2000000000000006, 140, 91416, 0.99
901, 16, -1.5000000000000002, 141, 91557, 0.99
902, 28, -2.700000000000001, 141, 91698, 0.99
903, 17, -1.6000000000000003, 136, 91834, 0.99
904, 20, -1.9000000000000006, 136, 91970, 0.99
905, 20, -1.9000000000000006, 141, 92111, 0.99
906, 18, -1.7000000000000004, 140, 92251, 0.99
907, 15, -1.4000000000000001, 130, 92381, 0.99
908, 18, -1.7000000000000004, 148, 92529, 0.99
909, 19, -3.6, 137, 92666, 0.99
910, 20, -1.9000000000000006, 134, 92800, 0.99
911, 17, -2.5, 140, 92940, 0.99
912, 16, -2.4000000000000004, 143, 93083, 0.99
913, 18, -1.7000000000000004, 150, 93233, 0.99
914, 17, -2.5, 141, 93374, 0.99
915, 22, -6.799999999999998, 142, 93516, 0.99
916, 48, -4.699999999999999, 139, 93655, 0.99
917, 20, -1.9000000000000006, 140, 93795, 0.99
918, 17, -3.4, 138, 93933, 0.99
919, 25, -3.3000000000000007, 139, 94072, 0.99
920, 18, -2.6000000000000005, 148, 94220, 0.99
921, 17, -1.6000000000000003, 143, 94363, 0.99
922, 21, -2.0000000000000004, 134, 94497, 0.99
923, 18, -1.7000000000000004, 146, 94643, 0.99
924, 22, -2.1000000000000005, 144, 94787, 0.99
925, 16, -1.5000000000000002, 138, 94925, 0.99
926, 23, -3.1000000000000005, 142, 95067, 0.99
927, 18, -1.7000000000000004, 140, 95207, 0.99
928, 19, -1.8000000000000005, 136, 95343, 0.99
929, 25, -3.3000000000000007, 143, 95486, 0.99
930, 16, -1.5000000000000002, 143, 95629, 0.99
931, 20, -2.8000000000000007, 134, 95763, 0.99
932, 16, -1.5000000000000002, 145, 95908, 0.99
933, 21, -2.9000000000000004, 141, 96049, 0.99
934, 19, -1.8000000000000005, 141, 96190, 0.99
935, 20, -2.8000000000000007, 137, 96327, 0.99
936, 19, -1.8000000000000005, 140, 96467, 0.99
937, 19, -2.7, 149, 96616, 0.99
938, 35, -3.4000000000000017, 134, 96750, 0.99
939, 18, -5.499999999999998, 140, 96890, 0.99
940, 18, -1.7000000000000004, 142, 97032, 0.99
941, 15, -1.4000000000000001, 143, 97175, 0.99
942, 19, -1.8000000000000005, 142, 97317, 0.99
943, 18, -2.6000000000000005, 143, 97460, 0.99
944, 26, -2.500000000000001, 145, 97605, 0.99
945, 20, -1.9000000000000006, 142, 97747, 0.99
946, 15, -1.4000000000000001, 151, 97898, 0.99
947, 62, -6.099999999999994, 147, 98045, 0.99
948, 18, -1.7000000000000004, 139, 98184, 0.99
949, 18, -1.7000000000000004, 154, 98338, 0.99
950, 20, -1.9000000000000006, 142, 98480, 0.99
951, 16, -1.5000000000000002, 144, 98624, 0.99
952, 64, -8.199999999999994, 135, 98759, 0.99
953, 16, -2.4000000000000004, 137, 98896, 0.99
954, 22, -2.1000000000000005, 145, 99041, 0.99
955, 42, -4.100000000000001, 142, 99183, 0.99
956, 21, -3.9000000000000004, 145, 99328, 0.99
957, 21, -2.0000000000000004, 145, 99473, 0.99
958, 20, -3.8000000000000007, 150, 99623, 0.99
959, 22, -2.1000000000000005, 142, 99765, 0.99
960, 18, -1.7000000000000004, 141, 99906, 0.99
961, 59, -6.699999999999996, 153, 100059, 0.99
962, 18, -1.7000000000000004, 140, 100199, 0.99
963, 29, -2.800000000000001, 142, 100341, 0.99
964, 18, -1.7000000000000004, 143, 100484, 0.99
965, 23, -3.100000000000001, 144, 100628, 0.99
966, 19, -1.8000000000000005, 145, 100773, 0.99
967, 21, -2.9000000000000004, 142, 100915, 0.99
968, 19, -1.8000000000000005, 146, 101061, 0.99
969, 18, -1.7000000000000004, 149, 101210, 0.99
970, 20, -2.8000000000000007, 134, 101344, 0.99
971, 27, -2.600000000000001, 146, 101490, 0.99
972, 30, -2.9000000000000012, 140, 101630, 0.99
973, 21, -2.0000000000000004, 140, 101770, 0.99
974, 17, -1.6000000000000003, 142, 101912, 0.99
975, 34, -3.3000000000000016, 142, 102054, 0.99
976, 21, -2.0000000000000004, 146, 102200, 0.99
977, 18, -1.7000000000000004, 146, 102346, 0.99
978, 23, -2.2000000000000006, 149, 102495, 0.99
979, 23, -3.1000000000000005, 137, 102632, 0.99
980, 20, -2.8000000000000007, 147, 102779, 0.99
981, 26, -2.500000000000001, 141, 102920, 0.99
982, 19, -2.7, 149, 103069, 0.99
983, 23, -2.2000000000000006, 144, 103213, 0.99
984, 26, -2.500000000000001, 146, 103359, 0.99
985, 15, -1.4000000000000001, 148, 103507, 0.99
986, 19, -1.8000000000000005, 144, 103651, 0.99
987, 28, -3.600000000000001, 143, 103794, 0.99
988, 20, -2.8000000000000007, 142, 103936, 0.99
989, 16, -1.5000000000000002, 149, 104085, 0.99
990, 18, -1.7000000000000004, 146, 104231, 0.99
991, 21, -2.9000000000000004, 150, 104381, 0.99
992, 20, -1.9000000000000006, 155, 104536, 0.99
993, 64, -6.299999999999994, 141, 104677, 0.99
994, 18, -1.7000000000000004, 145, 104822, 0.99
995, 18, -1.7000000000000004, 143, 104965, 0.99
996, 20, -1.9000000000000006, 149, 105114, 0.99
997, 21, -2.0000000000000004, 141, 105255, 0.99
998, 64, -6.299999999999994, 149, 105404, 0.99
999, 20, -1.9000000000000006, 151, 105555, 0.99
1000, 25, -4.3, 140, 105695, 0.99
1001, 19, -1.8000000000000005, 153, 105848, 0.99
1002, 16, -1.5000000000000002, 146, 105994, 0.99
1003, 16, -1.5000000000000002, 141, 106135, 0.99
1004, 30, -6.599999999999996, 159, 106294, 0.99
1005, 19, -1.8000000000000005, 144, 106438, 0.99
1006, 18, -1.7000000000000004, 156, 106594, 0.99
1007, 18, -1.7000000000000004, 142, 106736, 0.99
1008, 23, -2.2000000000000006, 143, 106879, 0.99
1009, 24, -4.199999999999999, 151, 107030, 0.99
1010, 24, -2.3000000000000007, 150, 107180, 0.99
1011, 30, -4.6999999999999975, 143, 107323, 0.99
1012, 21, -2.0000000000000004, 148, 107471, 0.99
1013, 19, -1.8000000000000005, 152, 107623, 0.99
1014, 17, -1.6000000000000003, 140, 107763, 0.99
1015, 22, -3.9000000000000004, 152, 107915, 0.99
1016, 16, -1.5000000000000002, 147, 108062, 0.99
1017, 17, -1.6000000000000003, 148, 108210, 0.99
1018, 25, -2.400000000000001, 148, 108358, 0.99
1019, 19, -1.8000000000000005, 153, 108511, 0.99
1020, 24, -2.3000000000000007, 143, 108654, 0.99
1021, 19, -1.8000000000000005, 144, 108798, 0.99
1022, 17, -1.6000000000000003, 151, 108949, 0.99
1023, 18, -2.6000000000000005, 147, 109096, 0.99
1024, 20, -1.9000000000000006, 150, 109246, 0.99
1025, 20, -1.9000000000000006, 156, 109402, 0.99
1026, 31, -3.0000000000000013, 158, 109560, 0.99
1027, 44, -9.999999999999993, 153, 109713, 0.99
1028, 22, -2.1000000000000005, 152, 109865, 0.99
1029, 17, -1.6000000000000003, 150, 110015, 0.99
1030, 22, -2.1000000000000005, 145, 110160, 0.99
1031, 25, -2.400000000000001, 146, 110306, 0.99
1032, 16, -1.5000000000000002, 157, 110463, 0.99
1033, 24, -4.100000000000001, 149, 110612, 0.99
1034, 18, -1.7000000000000004, 152, 110764, 0.99
1035, 22, -2.1000000000000005, 155, 110919, 0.99
1036, 20, -1.9000000000000006, 147, 111066, 0.99
1037, 64, -6.299999999999994, 146, 111212, 0.99
1038, 19, -1.8000000000000005, 145, 111357, 0.99
1039, 28, -4.500000000000001, 151, 111508, 0.99
1040, 17, -1.6000000000000003, 150, 111658, 0.99
1041, 16, -1.5000000000000002, 148, 111806, 0.99
1042, 24, -3.200000000000001, 146, 111952, 0.99
1043, 17, -1.6000000000000003, 150, 112102, 0.99
1044, 19, -1.8000000000000005, 146, 112248, 0.99
1045, 22, -4.000000000000001, 152, 112400, 0.99
1046, 33, -3.2000000000000015, 176, 112576, 0.99
1047, 23, -2.2000000000000006, 160, 112736, 0.99
1048, 19, -3.6, 154, 112890, 0.99
1049, 22, -2.1000000000000005, 152, 113042, 0.99
1050, 34, -3.3000000000000016, 150, 113192, 0.99
1051, 35, -3.4000000000000017, 162, 113354, 0.99
1052, 20, -1.9000000000000006, 171, 113525, 0.99
1053, 20, -2.8000000000000007, 150, 113675, 0.99
1054, 19, -1.8000000000000005, 147, 113822, 0.99
1055, 19, -1.8000000000000005, 149, 113971, 0.99
1056, 18, -1.7000000000000004, 144, 114115, 0.99
1057, 23, -4.1000000000000005, 153, 114268, 0.99
1058, 64, -8.199999999999985, 147, 114415, 0.99
1059, 20, -1.9000000000000006, 159, 114574, 0.99
1060, 24, -2.3000000000000007, 153, 114727, 0.99
1061, 16, -1.5000000000000002, 150, 114877, 0.99
1062, 24, -3.2000000000000006, 154, 115031, 0.99
1063, 27, -2.600000000000001, 148, 115179, 0.99
1064, 24, -4.2, 145, 115324, 0.99
1065, 16, -1.5000000000000002, 153, 115477, 0.99
1066, 20, -1.9000000000000006, 149, 115626, 0.99
1067, 38, -11.999999999999995, 152, 115778, 0.99
1068, 17, -1.6000000000000003, 152, 115930, 0.99
1069, 43, -4.200000000000001, 149, 116079, 0.99
1070, 21, -2.0000000000000004, 164, 116243, 0.99
1071, 22, -3.0000000000000004, 148, 116391, 0.99
1072, 18, -1.7000000000000004, 156, 116547, 0.99
1073, 22, -2.1000000000000005, 150, 116697, 0.99
1074, 20, -1.9000000000000006, 154, 116851, 0.99
1075, 15, -1.4000000000000001, 148, 116999, 0.99
1076, 20, -2.8000000000000007, 156, 117155, 0.99
1077, 25, -2.400000000000001, 147, 117302, 0.99
1078, 23, -2.2000000000000006, 156, 117458, 0.99
1079, 25, -2.400000000000001, 151, 117609, 0.99
1080, 15, -1.4000000000000001, 159, 117768, 0.99
1081, 21, -2.9000000000000004, 159, 117927, 0.99
1082, 18, -2.6000000000000005, 160, 118087, 0.99
1083, 21, -2.9000000000000004, 149, 118236, 0.99
1084, 32, -3.1000000000000014, 151, 118387, 0.99
1085, 38, -3.700000000000002, 166, 118553, 0.99
1086, 17, -3.5000000000000004, 158, 118711, 0.99
1087, 22, -3.900000000000001, 151, 118862, 0.99
1088, 16, -1.5000000000000002, 148, 119010, 0.99
1089, 16, -1.5000000000000002, 156, 119166, 0.99
1090, 22, -2.1000000000000005, 149, 119315, 0.99
1091, 17, -1.6000000000000003, 161, 119476, 0.99
1092, 24, -2.3000000000000007, 148, 119624, 0.99
1093, 17, -1.6000000000000003, 156, 119780, 0.99
1094, 22, -2.1000000000000005, 156, 119936, 0.99
1095, 27, -2.600000000000001, 155, 120091, 0.99
1096, 17, -1.6000000000000003, 158, 120249, 0.99
1097, 16, -1.5000000000000002, 154, 120403, 0.99
1098, 25, -2.400000000000001, 158, 120561, 0.99
1099, 19, -1.8000000000000005, 152, 120713, 0.99
1100, 56, -5.4999999999999964, 156, 120869, 0.99
1101, 19, -1.8000000000000005, 151, 121020, 0.99
1102, 44, -6.199999999999992, 154, 121174, 0.99
1103, 31, -3.9000000000000012, 157, 121331, 0.99
1104, 21, -2.9000000000000004, 162, 121493, 0.99
1105, 20, -1.9000000000000006, 145, 121638, 0.99
1106, 21, -2.9000000000000004, 150, 121788, 0.99
1107, 25, -4.199999999999999, 159, 121947, 0.99
1108, 16, -2.4000000000000004, 155, 122102, 0.99
1109, 31, -3.0000000000000013, 160, 122262, 0.99
1110, 23, -2.2000000000000006, 160, 122422, 0.99
1111, 23, -2.2000000000000006, 158, 122580, 0.99
1112, 22, -3.000000000000001, 149, 122729, 0.99
1113, 19, -2.7, 151, 122880, 0.99
1114, 19, -3.7000000000000006, 151, 123031, 0.99
1115, 22, -2.1000000000000005, 155, 123186, 0.99
1116, 20, -1.9000000000000006, 155, 123341, 0.99
1117, 17, -1.6000000000000003, 163, 123504, 0.99
1118, 17, -1.6000000000000003, 153, 123657, 0.99
1119, 22, -3.9000000000000004, 156, 123813, 0.99
1120, 22, -2.1000000000000005, 157, 123970, 0.99
1121, 17, -1.6000000000000003, 153, 124123, 0.99
1122, 64, -6.299999999999994, 151, 124274, 0.99
1123, 27, -2.600000000000001, 158, 124432, 0.99
1124, 17, -1.6000000000000003, 154, 124586, 0.99
1125, 22, -2.1000000000000005, 168, 124754, 0.99
1126, 15, -1.4000000000000001, 151, 124905, 0.99
1127, 64, -6.299999999999994, 162, 125067, 0.99
1128, 26, -3.400000000000001, 158, 125225, 0.99
1129, 19, -1.8000000000000005, 159, 125384, 0.99
1130, 23, -4.1, 160, 125544, 0.99
1131, 23, -2.2000000000000006, 160, 125704, 0.99
1132, 28, -4.599999999999999, 160, 125864, 0.99
1133, 20, -1.9000000000000006, 155, 126019, 0.99
1134, 18, -1.7000000000000004, 159, 126178, 0.99
1135, 26, -2.500000000000001, 159, 126337, 0.99
1136, 23, -3.1000000000000005, 158, 126495, 0.99
1137, 24, -4.2, 151, 126646, 0.99
1138, 21, -2.9000000000000004, 159, 126805, 0.99
1139, 21, -2.0000000000000004, 159, 126964, 0.99
1140, 25, -2.400000000000001, 150, 127114, 0.99
1141, 16, -3.3, 162, 127276, 0.99
1142, 21, -2.9000000000000004, 155, 127431, 0.99
1143, 21, -2.9000000000000004, 150, 127581, 0.99
1144, 22, -7.799999999999997, 171, 127752, 0.99
1145, 21, -3.9000000000000004, 161, 127913, 0.99
1146, 19, -1.8000000000000005, 156, 128069, 0.99
1147, 19, -1.8000000000000005, 160, 128229, 0.99
1148, 25, -2.400000000000001, 168, 128397, 0.99
1149, 18, -1.7000000000000004, 160, 128557, 0.99
1150, 18, -2.6000000000000005, 154, 128711, 0.99
1151, 22, -2.1000000000000005, 164, 128875, 0.99
1152, 17, -1.6000000000000003, 165, 129040, 0.99
1153, 61, -5.999999999999995, 152, 129192, 0.99
1154, 15, -2.3, 156, 129348, 0.99
1155, 16, -2.4000000000000004, 156, 129504, 0.99
1156, 26, -5.2, 153, 129657, 0.99
1157, 24, -6.000000000000001, 164, 129821, 0.99
1158, 31, -4.800000000000001, 167, 129988, 0.99
1159, 19, -1.8000000000000005, 166, 130154, 0.99
1160, 23, -2.2000000000000006, 157, 130311, 0.99
1161, 28, -2.700000000000001, 163, 130474, 0.99
1162, 17, -1.6000000000000003, 154, 130628, 0.99
1163, 21, -2.0000000000000004, 162, 130790, 0.99
1164, 20, -3.8000000000000007, 169, 130959, 0.99
1165, 17, -1.6000000000000003, 168, 131127, 0.99
1166, 32, -5.999999999999997, 163, 131290, 0.99
1167, 18, -2.6000000000000005, 172, 131462, 0.99
1168, 23, -2.2000000000000006, 160, 131622, 0.99
1169, 17, -1.6000000000000003, 175, 131797, 0.99
1170, 22, -2.1000000000000005, 165, 131962, 0.99
1171, 37, -4.499999999999999, 177, 132139, 0.99
1172, 20, -1.9000000000000006, 170, 132309, 0.99
1173, 16, -1.5000000000000002, 172, 132481, 0.99
1174, 28, -2.700000000000001, 157, 132638, 0.99
1175, 56, -6.399999999999992, 163, 132801, 0.99
1176, 16, -1.5000000000000002, 158, 132959, 0.99
1177, 15, -1.4000000000000001, 164, 133123, 0.99
1178, 19, -1.8000000000000005, 162, 133285, 0.99
1179, 15, -2.3, 172, 133457, 0.99
1180, 29, -4.699999999999998, 154, 133611, 0.99
1181, 26, -2.500000000000001, 166, 133777, 0.99
1182, 24, -4.1000000000000005, 167, 133944, 0.99
1183, 17, -1.6000000000000003, 160, 134104, 0.99
1184, 20, -1.9000000000000006, 158, 134262, 0.99
1185, 23, -2.2000000000000006, 181, 134443, 0.99
1186, 21, -6.6999999999999975, 151, 134594, 0.99
1187, 28, -2.700000000000001, 180, 134774, 0.99
1188, 20, -1.9000000000000006, 175, 134949, 0.99
1189, 20, -1.9000000000000006, 158, 135107, 0.99
1190, 18, -1.7000000000000004, 165, 135272, 0.99
1191, 28, -2.700000000000001, 175, 135447, 0.99
1192, 17, -1.6000000000000003, 156, 135603, 0.99
1193, 23, -2.2000000000000006, 170, 135773, 0.99
1194, 17, -1.6000000000000003, 158, 135931, 0.99
1195, 44, -5.200000000000001, 161, 136092, 0.99
1196, 18, -1.7000000000000004, 163, 136255, 0.99
1197, 26, -2.500000000000001, 169, 136424, 0.99
1198, 25, -2.400000000000001, 169, 136593, 0.99
1199, 39, -3.800000000000002, 166, 136759, 0.99
1200, 18, -1.7000000000000004, 154, 136913, 0.99
1201, 64, -6.299999999999994, 161, 137074, 0.99
1202, 20, -1.9000000000000006, 160, 137234, 0.99
1203, 19, -1.8000000000000005, 170, 137404, 0.99
1204, 25, -4.2, 162, 137566, 0.99
1205, 19, -2.7, 169, 137735, 0.99
1206, 28, -2.700000000000001, 167, 137902, 0.99
1207, 15, -1.4000000000000001, 162, 138064, 0.99
1208, 23, -4.9, 164, 138228, 0.99
1209, 37, -8.299999999999994, 168, 138396, 0.99
1210, 22, -3.0000000000000004, 161, 138557, 0.99
1211, 18, -1.7000000000000004, 166, 138723, 0.99
1212, 22, -5.899999999999998, 161, 138884, 0.99
1213, 22, -3.0000000000000004, 159, 139043, 0.99
1214, 21, -2.9000000000000004, 156, 139199, 0.99
1215, 18, -1.7000000000000004, 159, 139358, 0.99
1216, 64, -6.299999999999994, 172, 139530, 0.99
1217, 16, -2.4000000000000004, 167, 139697, 0.99
1218, 17, -2.5, 168, 139865, 0.99
1219, 31, -4.799999999999997, 167, 140032, 0.99
1220, 16, -1.5000000000000002, 161, 140193, 0.99
1221, 22, -4.000000000000001, 159, 140352, 0.99
1222, 20, -1.9000000000000006, 175, 140527, 0.99
1223, 15, -1.4000000000000001, 167, 140694, 0.99
1224, 23, -4.1000000000000005, 165, 140859, 0.99
1225, 21, -2.0000000000000004, 166, 141025, 0.99
1226, 64, -6.299999999999994, 163, 141188, 0.99
1227, 29, -4.699999999999998, 162, 141350, 0.99
1228, 17, -2.5, 173, 141523, 0.99
1229, 46, -4.5, 161, 141684, 0.99
1230, 55, -5.399999999999997, 159, 141843, 0.99
1231, 37, -14.899999999999993, 162, 142005, 0.99
1232, 19, -3.6, 161, 142166, 0.99
1233, 15, -1.4000000000000001, 171, 142337, 0.99
1234, 21, -3.900000000000001, 173, 142510, 0.99
1235, 29, -2.800000000000001, 173, 142683, 0.99
1236, 21, -2.0000000000000004, 164, 142847, 0.99
1237, 19, -1.8000000000000005, 164, 143011, 0.99
1238, 20, -2.8000000000000007, 155, 143166, 0.99
1239, 22, -2.1000000000000005, 160, 143326, 0.99
1240, 18, -2.6000000000000005, 177, 143503, 0.99
1241, 24, -2.3000000000000007, 167, 143670, 0.99
1242, 30, -4.799999999999998, 168, 143838, 0.99
1243, 64, -10.099999999999994, 166, 144004, 0.99
1244, 20, -3.8000000000000007, 164, 144168, 0.99
1245, 16, -1.5000000000000002, 165, 144333, 0.99
1246, 22, -2.1000000000000005, 168, 144501, 0.99
1247, 29, -4.699999999999998, 166, 144667, 0.99
1248, 15, -1.4000000000000001, 160, 144827, 0.99
1249, 18, -1.7000000000000004, 169, 144996, 0.99
1250, 18, -1.7000000000000004, 162, 145158, 0.99
1251, 17, -1.6000000000000003, 163, 145321, 0.99
1252, 24, -2.3000000000000007, 170, 145491, 0.99
1253, 16, -2.4000000000000004, 166, 145657, 0.99
1254, 18, -1.7000000000000004, 176, 145833, 0.99
1255, 15, -1.4000000000000001, 181, 146014, 0.99
1256, 26, -2.500000000000001, 173, 146187, 0.99
1257, 19, -3.7, 166, 146353, 0.99
1258, 17, -3.5000000000000004, 162, 146515, 0.99
1259, 25, -2.400000000000001, 174, 146689, 0.99
1260, 25, -2.400000000000001, 182, 146871, 0.99
1261, 30, -2.9000000000000012, 162, 147033, 0.99
1262, 17, -1.6000000000000003, 167, 147200, 0.99
1263, 22, -2.1000000000000005, 163, 147363, 0.99
1264, 64, -8.099999999999994, 160, 147523, 0.99
1265, 27, -4.499999999999999, 169, 147692, 0.99
1266, 22, -2.1000000000000005, 166, 147858, 0.99
1267, 16, -1.5000000000000002, 162, 148020, 0.99
1268, 27, -5.3, 161, 148181, 0.99
1269, 22, -2.1000000000000005, 172, 148353, 0.99
1270, 19, -1.8000000000000005, 174, 148527, 0.99
1271, 17, -2.5, 170, 148697, 0.99
1272, 17, -1.6000000000000003, 158, 148855, 0.99
1273, 20, -1.9000000000000006, 161, 149016, 0.99
1274, 20, -1.9000000000000006, 163, 149179, 0.99
1275, 18, -1.7000000000000004, 181, 149360, 0.99
1276, 23, -2.2000000000000006, 164, 149524, 0.99
1277, 22, -2.1000000000000005, 164, 149688, 0.99
1278, 21, -2.9000000000000004, 168, 149856, 0.99
1279, 18, -1.7000000000000004, 159, 150015, 0.99
1280, 20, -2.8000000000000007, 162, 150177, 0.99
1281, 28, -3.600000000000001, 175, 150352, 0.99
1282, 16, -2.4000000000000004, 171, 150523, 0.99
1283, 36, -3.5000000000000018, 167, 150690, 0.99
1284, 21, -3.8000000000000007, 164, 150854, 0.99
1285, 25, -3.3000000000000007, 166, 151020, 0.99
1286, 44, -9.999999999999993, 169, 151189, 0.99
1287, 16, -1.5000000000000002, 168, 151357, 0.99
1288, 19, -3.7, 170, 151527, 0.99
1289, 24, -2.3000000000000007, 165, 151692, 0.99
1290, 17, -3.5000000000000004, 166, 151858, 0.99
1291, 27, -11.099999999999998, 160, 152018, 0.99
1292, 21, -2.0000000000000004, 182, 152200, 0.99
1293, 19, -1.8000000000000005, 173, 152373, 0.99
1294, 20, -1.9000000000000006, 162, 152535, 0.99
1295, 38, -3.700000000000002, 165, 152700, 0.99
1296, 19, -1.8000000000000005, 170, 152870, 0.99
1297, 20, -1.9000000000000006, 162, 153032, 0.99
1298, 19, -1.8000000000000005, 167, 153199, 0.99
1299, 15, -1.4000000000000001, 167, 153366, 0.99
1300, 16, -3.3000000000000003, 159, 153525, 0.99
1301, 32, -4.999999999999998, 165, 153690, 0.99
1302, 24, -2.3000000000000007, 162, 153852, 0.99
1303, 64, -6.299999999999994, 167, 154019, 0.99
1304, 21, -2.0000000000000004, 164, 154183, 0.99
1305, 22, -2.1000000000000005, 169, 154352, 0.99
1306, 16, -1.5000000000000002, 164, 154516, 0.99
1307, 22, -3.0000000000000004, 171, 154687, 0.99
1308, 18, -1.7000000000000004, 168, 154855, 0.99
1309, 27, -4.499999999999999, 169, 155024, 0.99
1310, 21, -5.799999999999997, 166, 155190, 0.99
1311, 24, -2.3000000000000007, 173, 155363, 0.99
1312, 19, -1.8000000000000005, 160, 155523, 0.99
1313, 18, -1.7000000000000004, 175, 155698, 0.99
1314, 15, -1.4000000000000001, 172, 155870, 0.99
1315, 17, -3.4000000000000004, 162, 156032, 0.99
1316, 25, -2.400000000000001, 169, 156201, 0.99
1317, 16, -1.5000000000000002, 179, 156380, 0.99
1318, 27, -8.299999999999995, 165, 156545, 0.99
1319, 15, -1.4000000000000001, 169, 156714, 0.99
1320, 18, -1.7000000000000004, 171, 156885, 0.99
1321, 55, -6.299999999999997, 167, 157052, 0.99
1322, 18, -2.6000000000000005, 165, 157217, 0.99
1323, 23, -3.1000000000000005, 175, 157392, 0.99
1324, 19, -1.8000000000000005, 163, 157555, 0.99
1325, 18, -1.7000000000000004, 161, 157716, 0.99
1326, 20, -1.9000000000000006, 175, 157891, 0.99
1327, 20, -1.9000000000000006, 182, 158073, 0.99
1328, 49, -4.799999999999999, 165, 158238, 0.99
1329, 22, -2.1000000000000005, 176, 158414, 0.99
1330, 61, -5.999999999999995, 164, 158578, 0.99
1331, 17, -1.6000000000000003, 172, 158750, 0.99
1332, 17, -2.5, 175, 158925, 0.99
1333, 22, -3.9000000000000004, 179, 159104, 0.99
1334, 25, -2.400000000000001, 171, 159275, 0.99
1335, 20, -1.9000000000000006, 181, 159456, 0.99
1336, 20, -1.9000000000000006, 169, 159625, 0.99
1337, 21, -2.0000000000000004, 167, 159792, 0.99
1338, 18, -2.6000000000000005, 172, 159964, 0.99
1339, 27, -3.500000000000001, 185, 160149, 0.99
1340, 30, -2.9000000000000012, 190, 160339, 0.99
1341, 41, -4.000000000000002, 176, 160515, 0.99
1342, 19, -1.8000000000000005, 171, 160686, 0.99
1343, 15, -1.4000000000000001, 169, 160855, 0.99
1344, 17, -1.6000000000000003, 171, 161026, 0.99
1345, 19, -1.8000000000000005, 172, 161198, 0.99
1346, 20, -1.9000000000000006, 164, 161362, 0.99
1347, 19, -1.8000000000000005, 173, 161535, 0.99
1348, 21, -2.9000000000000004, 172, 161707, 0.99
1349, 22, -2.1000000000000005, 177, 161884, 0.99
1350, 19, -1.8000000000000005, 170, 162054, 0.99
1351, 23, -4.1, 171, 162225, 0.99
1352, 37, -3.600000000000002, 187, 162412, 0.99
1353, 28, -3.600000000000001, 172, 162584, 0.99
1354, 19, -1.8000000000000005, 168, 162752, 0.99
1355, 23, -3.1000000000000005, 170, 162922, 0.99
1356, 30, -7.599999999999996, 175, 163097, 0.99
1357, 20, -1.9000000000000006, 176, 163273, 0.99
1358, 19, -3.6, 174, 163447, 0.99
1359, 40, -3.900000000000002, 167, 163614, 0.99
1360, 21, -2.0000000000000004, 172, 163786, 0.99
1361, 19, -1.8000000000000005, 182, 163968, 0.99
1362, 22, -3.0000000000000004, 169, 164137, 0.99
1363, 19, -3.7000000000000006, 180, 164317, 0.99
1364, 18, -1.7000000000000004, 179, 164496, 0.99
1365, 25, -3.3000000000000007, 168, 164664, 0.99
1366, 18, -1.7000000000000004, 176, 164840, 0.99
1367, 20, -1.9000000000000006, 167, 165007, 0.99
1368, 24, -3.2000000000000006, 171, 165178, 0.99
1369, 28, -3.600000000000001, 173, 165351, 0.99
1370, 17, -1.6000000000000003, 169, 165520, 0.99
1371, 64, -6.299999999999994, 174, 165694, 0.99
1372, 19, -1.8000000000000005, 174, 165868, 0.99
1373, 22, -3.0000000000000004, 175, 166043, 0.99
1374, 16, -1.5000000000000002, 172, 166215, 0.99
1375, 61, -11.599999999999985, 187, 166402, 0.99
1376, 20, -1.9000000000000006, 175, 166577, 0.99
1377, 22, -3.0000000000000004, 170, 166747, 0.99
1378, 20, -1.9000000000000006, 178, 166925, 0.99
1379, 19, -1.8000000000000005, 172, 167097, 0.99
1380, 19, -1.8000000000000005, 175, 167272, 0.99
1381, 22, -2.1000000000000005, 173, 167445, 0.99
1382, 21, -2.0000000000000004, 179, 167624, 0.99
1383, 20, -1.9000000000000006, 166, 167790, 0.99
1384, 15, -1.4000000000000001, 170, 167960, 0.99
1385, 23, -2.2000000000000006, 176, 168136, 0.99
1386, 24, -2.3000000000000007, 173, 168309, 0.99
1387, 18, -1.7000000000000004, 176, 168485, 0.99
1388, 44, -6.199999999999993, 172, 168657, 0.99
1389, 20, -3.8000000000000007, 175, 168832, 0.99
1390, 17, -1.6000000000000003, 172, 169004, 0.99
1391, 18, -1.7000000000000004, 169, 169173, 0.99
1392, 15, -1.4000000000000001, 168, 169341, 0.99
1393, 64, -6.299999999999994, 168, 169509, 0.99
1394, 15, -1.4000000000000001, 178, 169687, 0.99
1395, 21, -2.0000000000000004, 172, 169859, 0.99
1396, 29, -4.6, 171, 170030, 0.99
1397, 20, -2.8000000000000007, 170, 170200, 0.99
1398, 18, -1.7000000000000004, 182, 170382, 0.99
1399, 15, -1.4000000000000001, 175, 170557, 0.99
1400, 30, -2.9000000000000012, 176, 170733, 0.99
1401, 23, -3.1000000000000005, 186, 170919, 0.99
1402, 23, -3.1000000000000005, 181, 171100, 0.99
1403, 20, -1.9000000000000006, 188, 171288, 0.99
1404, 20, -1.9000000000000006, 191, 171479, 0.99
1405, 18, -1.7000000000000004, 176, 171655, 0.99
1406, 19, -1.8000000000000005, 180, 171835, 0.99
1407, 24, -3.2000000000000006, 174, 172009, 0.99
1408, 34, -3.3000000000000016, 182, 172191, 0.99
1409, 41, -4.000000000000002, 179, 172370, 0.99
1410, 23, -2.2000000000000006, 172, 172542, 0.99
1411, 18, -1.7000000000000004, 175, 172717, 0.99
1412, 18, -2.6, 178, 172895, 0.99
1413, 21, -2.0000000000000004, 178, 173073, 0.99
1414, 21, -2.0000000000000004, 190, 173263, 0.99
1415, 21, -4.7, 172, 173435, 0.99
1416, 18, -1.7000000000000004, 179, 173614, 0.99
1417, 20, -3.7000000000000006, 182, 173796, 0.99
1418, 19, -1.8000000000000005, 179, 173975, 0.99
1419, 19, -1.8000000000000005, 176, 174151, 0.99
1420, 23, -2.2000000000000006, 181, 174332, 0.99
1421, 16, -1.5000000000000002, 178, 174510, 0.99
1422, 18, -1.7000000000000004, 179, 174689, 0.99
1423, 27, -2.600000000000001, 178, 174867, 0.99
1424, 18, -1.7000000000000004, 175, 175042, 0.99
1425, 21, -3.8000000000000007, 173, 175215, 0.99
1426, 24, -2.3000000000000007, 180, 175395, 0.99
1427, 26, -4.399999999999999, 176, 175571, 0.99
1428, 20, -1.9000000000000006, 177, 175748, 0.99
1429, 21, -2.0000000000000004, 177, 175925, 0.99
1430, 23, -2.2000000000000006, 184, 176109, 0.99
1431, 19, -1.8000000000000005, 186, 176295, 0.99
1432, 18, -2.6000000000000005, 184, 176479, 0.99
1433, 31, -3.0000000000000013, 172, 176651, 0.99
1434, 16, -1.5000000000000002, 183, 176834, 0.99
1435, 22, -2.1000000000000005, 172, 177006, 0.99
1436, 20, -2.8000000000000007, 180, 177186, 0.99
1437, 24, -5.1, 188, 177374, 0.99
1438, 31, -3.0000000000000013, 180, 177554, 0.99
1439, 25, -5.1, 191, 177745, 0.99
1440, 16, -1.5000000000000002, 187, 177932, 0.99
1441, 20, -2.8000000000000007, 185, 178117, 0.99
1442, 21, -2.0000000000000004, 184, 178301, 0.99
1443, 18, -1.7000000000000004, 177, 178478, 0.99
1444, 30, -2.9000000000000012, 182, 178660, 0.99
1445, 16, -2.4000000000000004, 179, 178839, 0.99
1446, 16, -1.5000000000000002, 176, 179015, 0.99
1447, 18, -3.6000000000000005, 176, 179191, 0.99
1448, 42, -6.799999999999998, 185, 179376, 0.99
1449, 26, -2.500000000000001, 173, 179549, 0.99
1450, 59, -5.799999999999995, 174, 179723, 0.99
1451, 17, -1.6000000000000003, 178, 179901, 0.99
1452, 24, -2.3000000000000007, 182, 180083, 0.99
1453, 21, -2.0000000000000004, 189, 180272, 0.99
1454, 24, -5.099999999999998, 178, 180450, 0.99
1455, 15, -2.3, 184, 180634, 0.99
1456, 31, -3.9000000000000012, 179, 180813, 0.99
1457, 22, -2.1000000000000005, 179, 180992, 0.99
1458, 23, -3.1000000000000005, 182, 181174, 0.99
1459, 22, -2.1000000000000005, 186, 181360, 0.99
1460, 20, -2.8000000000000007, 184, 181544, 0.99
1461, 22, -2.1000000000000005, 170, 181714, 0.99
1462, 20, -1.9000000000000006, 180, 181894, 0.99
1463, 19, -1.8000000000000005, 181, 182075, 0.99
1464, 15, -1.4000000000000001, 187, 182262, 0.99
1465, 17, -1.6000000000000003, 176, 182438, 0.99
1466, 27, -2.600000000000001, 176, 182614, 0.99
1467, 22, -2.1000000000000005, 189, 182803, 0.99
1468, 19, -1.8000000000000005, 173, 182976, 0.99
1469, 19, -1.8000000000000005, 183, 183159, 0.99
1470, 29, -3.700000000000001, 186, 183345, 0.99
1471, 19, -3.7000000000000006, 181, 183526, 0.99
1472, 64, -6.299999999999994, 179, 183705, 0.99
1473, 25, -3.300000000000001, 179, 183884, 0.99
1474, 23, -2.2000000000000006, 181, 184065, 0.99
1475, 17, -1.6000000000000003, 181, 184246, 0.99
1476, 17, -1.6000000000000003, 181, 184427, 0.99
1477, 25, -2.400000000000001, 187, 184614, 0.99
1478, 34, -3.3000000000000016, 188, 184802, 0.99
1479, 17, -3.5000000000000004, 179, 184981, 0.99
1480, 64, -8.99999999999999, 181, 185162, 0.99
1481, 64, -31.60000000000001, 177, 185339, 0.99
1482, 64, -6.299999999999994, 173, 185512, 0.99
1483, 19, -1.8000000000000005, 183, 185695, 0.99
1484, 19, -2.7, 180, 185875, 0.99
1485, 17, -2.5, 184, 186059, 0.99
1486, 21, -2.9000000000000004, 198, 186257, 0.99
1487, 20, -1.9000000000000006, 181, 186438, 0.99
1488, 64, -28.20000000000001, 193, 186631, 0.99
1489, 18, -1.7000000000000004, 186, 186817, 0.99
1490, 15, -1.4000000000000001, 192, 187009, 0.99
1491, 31, -3.0000000000000013, 174, 187183, 0.99
1492, 24, -2.3000000000000007, 186, 187369, 0.99
1493, 16, -1.5000000000000002, 185, 187554, 0.99
1494, 29, -2.800000000000001, 182, 187736, 0.99
1495, 25, -2.400000000000001, 175, 187911, 0.99
1496, 15, -1.4000000000000001, 180, 188091, 0.99
1497, 20, -1.9000000000000006, 189, 188280, 0.99
1498, 27, -6.399999999999997, 179, 188459, 0.99
1499, 29, -2.800000000000001, 180, 188639, 0.99
1500, 59, -6.699999999999996, 185, 188824, 0.99
